COUNTRY_CODE;NUTS_LEVEL;NUTS_CODE;NUTS_LABEL;Residential_Buildings_2012;Buildings_Private_Service_Sector_2012;Public_Buildings_2012;Total_heat_2012
BE;0;BE;BELGIQUE-BELGIË ;79137;19094;13636;111867
BE;1;BE1;RÉGION DE BRUXELLES-CAPITALE / BRUSSELS HOOFDSTEDELIJK GEWEST;7515;4088;2592;14195
BE;2;BE10;Région de Bruxelles-Capitale / Brussels Hoofdstedelijk Gewest;7515;4088;2592;14195
BE;3;BE100;Arr. de Bruxelles-Capitale / Arr. van Brussel-Hoofdstad;7515;4088;2592;14195
BE;1;BE2;VLAAMS GEWEST;44689;10329;7331;62349
BE;2;BE21;Prov. Antwerpen;12262;3283;2200;17745
BE;3;BE211;Arr. Antwerpen;6925;2084;1374;10383
BE;3;BE212;Arr. Mechelen;2279;597;377;3253
BE;3;BE213;Arr. Turnhout;3058;602;449;4109
BE;2;BE22;Prov. Limburg (BE);5720;1110;869;7699
BE;3;BE221;Arr. Hasselt;2780;626;500;3906
BE;3;BE222;Arr. Maaseik;1564;262;206;2032
BE;3;BE223;Arr. Tongeren;1377;222;162;1761
BE;2;BE23;Prov. Oost-Vlaanderen;10303;2038;1555;13896
BE;3;BE231;Arr. Aalst;2025;346;249;2620
BE;3;BE232;Arr. Dendermonde;1364;215;162;1741
BE;3;BE233;Arr. Eeklo;588;92;71;751
BE;3;BE234;Arr. Gent;3834;911;727;5472
BE;3;BE235;Arr. Oudenaarde;870;142;111;1123
BE;3;BE236;Arr. Sint-Niklaas;1622;332;234;2188
BE;2;BE24;Prov. Vlaams-Brabant;7580;2203;1443;11226
BE;3;BE241;Arr. Halle-Vilvoorde;4096;1449;790;6335
BE;3;BE242;Arr. Leuven;3484;754;653;4891
BE;2;BE25;Prov. West-Vlaanderen;8825;1696;1265;11786
BE;3;BE251;Arr. Brugge;2106;438;362;2906
BE;3;BE252;Arr. Diksmuide;344;56;39;439
BE;3;BE253;Arr. Ieper;749;122;96;967
BE;3;BE254;Arr. Kortrijk;2050;436;312;2798
BE;3;BE255;Arr. Oostende;1326;210;143;1679
BE;3;BE256;Arr. Roeselare;1034;216;161;1411
BE;3;BE257;Arr. Tielt;628;117;85;830
BE;3;BE258;Arr. Veurne;588;100;66;754
BE;1;BE3;RÉGION WALLONNE;26934;4668;3695;35297
BE;2;BE31;Prov. Brabant Wallon;2605;667;453;3725
BE;3;BE310;Arr. Nivelles;2605;667;453;3725
BE;2;BE32;Prov. Hainaut;10159;1591;1261;13011
BE;3;BE321;Arr. Ath;639;90;69;798
BE;3;BE322;Arr. Charleroi;3337;555;424;4316
BE;3;BE323;Arr. Mons;2027;322;264;2613
BE;3;BE324;Arr. Mouscron;537;88;69;694
BE;3;BE325;Arr. Soignies;1345;195;158;1698
BE;3;BE326;Arr. Thuin;1183;144;119;1446
BE;3;BE327;Arr. Tournai;1091;198;157;1446
BE;2;BE33;Prov. Liège;8360;1438;1157;10955
BE;3;BE331;Arr. Huy;824;115;100;1039
BE;3;BE332;Arr. Liège;4734;891;717;6342
BE;3;BE334;Arr. Waremme;540;74;55;669
BE;3;BE335;Arr. Verviers - communes francophones;1650;256;212;2118
BE;3;BE336;Bezirk Verviers - Deutschsprachige Gemeinschaft;612;102;74;788
BE;2;BE34;Prov. Luxembourg (BE);2167;338;277;2782
BE;3;BE341;Arr. Arlon;432;75;62;569
BE;3;BE342;Arr. Bastogne;360;55;46;461
BE;3;BE343;Arr. Marche-en-Famenne;484;77;66;627
BE;3;BE344;Arr. Neufchâteau;497;83;64;644
BE;3;BE345;Arr. Virton;395;49;38;482
BE;2;BE35;Prov. Namur;3643;635;547;4825
BE;3;BE351;Arr. Dinant;897;125;107;1129
BE;3;BE352;Arr. Namur;2209;443;382;3034
BE;3;BE353;Arr. Philippeville;537;67;58;662
BE;1;BEZ;EXTRA-REGIO NUTS 1;;;;0
BE;2;BEZZ;Extra-Regio NUTS 2;;;;0
BE;3;BEZZZ;Extra-Regio NUTS 3;;;;0
BG;0;BG;???????? (BULGARIA);21973;3684;1182;26839
BG;1;BG3;??????? ? ?????????? ???????? (SEVERNA I YUGOIZTOCHNA BULGARIA);11521;1449;440;13410
BG;2;BG31;????????????? (Severozapaden);2832;253;92;3177
BG;3;BG311;????? (Vidin);368;28;11;407
BG;3;BG312;??????? (Montana);505;39;16;560
BG;3;BG313;????? (Vratsa);619;53;20;692
BG;3;BG314;?????? (Pleven);814;90;30;934
BG;3;BG315;????? (Lovech);525;44;16;585
BG;2;BG32;??????? ????????? (Severen tsentralen);2608;307;98;3013
BG;3;BG321;?????? ??????? (Veliko Tarnovo);791;99;31;921
BG;3;BG322;??????? (Gabrovo);455;41;14;510
BG;3;BG323;???? (Ruse);705;97;28;830
BG;3;BG324;??????? (Razgrad);340;36;13;389
BG;3;BG325;???????? (Silistra);317;34;11;362
BG;2;BG33;????????????? (Severoiztochen);2795;460;129;3384
BG;3;BG331;????? (Varna);1340;299;75;1714
BG;3;BG332;?????? (Dobrich);560;69;20;649
BG;3;BG333;????? (Shumen);514;57;20;591
BG;3;BG334;????????? (Targovishte);381;34;13;428
BG;2;BG34;?????????? (Yugoiztochen);3286;430;122;3838
BG;3;BG341;?????? (Burgas);1393;216;52;1661
BG;3;BG342;?????? (Sliven);522;55;20;597
BG;3;BG343;????? (Yambol);386;39;12;437
BG;3;BG344;????? ?????? (Stara Zagora);985;120;38;1143
BG;1;BG4;?????????? ? ???? ????????? ???????? (YUGOZAPADNA I YUZHNA TSENTRALNA BULGARIA);10452;2235;742;13429
BG;2;BG41;?????????? (Yugozapaden);6375;1721;572;8668
BG;3;BG411;????? (???????) (Sofia (stolitsa));3561;1486;485;5532
BG;3;BG412;????? (Sofia);945;81;23;1049
BG;3;BG413;??????????? (Blagoevgrad);894;87;38;1019
BG;3;BG414;?????? (Pernik);511;34;13;558
BG;3;BG415;????????? (Kyustendil);463;33;13;509
BG;2;BG42;???? ????????? (Yuzhen tsentralen);4077;513;170;4760
BG;3;BG421;??????? (Plovdiv);1813;289;88;2190
BG;3;BG422;??????? (Haskovo);656;81;24;761
BG;3;BG423;????????? (Pazardzhik);772;73;28;873
BG;3;BG424;?????? (Smolyan);416;31;15;462
BG;3;BG425;???????? (Kardzhali);420;39;15;474
BG;1;BGZ;EXTRA-REGIO NUTS 1;;;;0
BG;2;BGZZ;Extra-Regio NUTS 2;;;;0
BG;3;BGZZZ;Extra-Regio NUTS 3;;;;0
CZ;0;CZ;?ESKÁ REPUBLIKA;60831;16010;7802;84643
CZ;1;CZ0;?ESKÁ REPUBLIKA;60831;16010;7802;84643
CZ;2;CZ01;Praha;7208;5161;2130;14499
CZ;3;CZ010;Hlavní m?sto Praha;7208;5161;2130;14499
CZ;2;CZ02;St?ední ?echy;7513;1643;696;9852
CZ;3;CZ020;St?edo?eský kraj;7513;1643;696;9852
CZ;2;CZ03;Jihozápad;7179;1439;787;9405
CZ;3;CZ031;Jiho?eský kraj;3758;749;403;4910
CZ;3;CZ032;Plze?ský kraj;3421;690;384;4495
CZ;2;CZ04;Severozápad;6403;1218;664;8285
CZ;3;CZ041;Karlovarský kraj;1759;334;198;2291
CZ;3;CZ042;Ústecký kraj;4645;883;467;5995
CZ;2;CZ05;Severovýchod;8962;1722;889;11573
CZ;3;CZ051;Liberecký kraj;2571;480;253;3304
CZ;3;CZ052;Královéhradecký kraj;3316;646;342;4304
CZ;3;CZ053;Pardubický kraj;3075;597;295;3967
CZ;2;CZ06;Jihovýchod;9408;2148;1131;12687
CZ;3;CZ063;Kraj Vyso?ina;2972;548;283;3803
CZ;3;CZ064;Jihomoravský kraj;6436;1600;848;8884
CZ;2;CZ07;St?ední Morava;6884;1326;740;8950
CZ;3;CZ071;Olomoucký kraj;3623;702;408;4733
CZ;3;CZ072;Zlínský kraj;3261;624;332;4217
CZ;2;CZ08;Moravskoslezsko;7275;1352;764;9391
CZ;3;CZ080;Moravskoslezský kraj;7275;1352;764;9391
CZ;1;CZZ;EXTRA-REGIO NUTS 1;;;;0
CZ;2;CZZZ;Extra-Regio NUTS 2;;;;0
CZ;3;CZZZZ;Extra-Regio NUTS 3;;;;0
DK;0;DK;DANMARK;42987;6784;6131;55902
DK;1;DK0;DANMARK;42987;6783;6128;55898
DK;2;DK01;Hovedstaden;12045;2903;2399;17347
DK;3;DK011;Byen København;4759;1504;1244;7507
DK;3;DK012;Københavns omegn;3604;928;705;5237
DK;3;DK013;Nordsjælland;3294;433;412;4139
DK;3;DK014;Bornholm;388;38;38;464
DK;2;DK02;Sjælland;6435;688;710;7833
DK;3;DK021;Østsjælland;1708;208;216;2132
DK;3;DK022;Vest- og Sydsjælland;4727;479;494;5700
DK;2;DK03;Syddanmark;9779;1251;1158;12188
DK;3;DK031;Fyn;3952;473;465;4890
DK;3;DK032;Sydjylland;5826;778;693;7297
DK;2;DK04;Midtjylland;9891;1347;1295;12533
DK;3;DK041;Vestjylland;3523;423;413;4359
DK;3;DK042;Østjylland;6369;924;882;8175
DK;2;DK05;Nordjylland;4837;596;566;5999
DK;3;DK050;Nordjylland;4837;596;566;5999
DK;1;DKZ;EXTRA-REGIO NUTS 1;;;;0
DK;2;DKZZ;Extra-Regio NUTS 2;;;;0
DK;3;DKZZZ;Extra-Regio NUTS 3;;;;0
DE;0;DE;DEUTSCHLAND ;558322;162033;73344;793699
DE;1;DE1;BADEN-WÜRTTEMBERG;71672;20904;9465;102041
DE;2;DE11;Stuttgart;26185;8037;3638;37860
DE;3;DE111;Stuttgart,Stadtkreis;3670;1805;817;6292
DE;3;DE112;Böblingen;2443;736;335;3514
DE;3;DE113;Esslingen;3380;954;432;4766
DE;3;DE114;Göppingen;1746;444;201;2391
DE;3;DE115;Ludwigsburg;3301;954;432;4687
DE;3;DE116;Rems-Murr-Kreis;2654;705;318;3677
DE;3;DE117;Heilbronn, Stadtkreis;728;280;126;1134
DE;3;DE118;Heilbronn, Landkreis;2124;565;254;2943
DE;3;DE119;Hohenlohekreis;729;209;95;1033
DE;3;DE11A;Schwäbisch Hall;1310;350;158;1818
DE;3;DE11B;Main-Tauber-Kreis;952;244;110;1306
DE;3;DE11C;Heidenheim;944;232;106;1282
DE;3;DE11D;Ostalbkreis;2205;560;255;3020
DE;2;DE12;Karlsruhe;18166;5433;2445;26044
DE;3;DE121;Baden-Baden, Stadtkreis;368;138;62;568
DE;3;DE122;Karlsruhe, Stadtkreis;1838;788;352;2978
DE;3;DE123;Karlsruhe, Landkreis;2910;747;335;3992
DE;3;DE124;Rastatt;1463;352;157;1972
DE;3;DE125;Heidelberg, Stadtkreis;898;389;175;1462
DE;3;DE126;Mannheim, Stadtkreis;1836;725;324;2885
DE;3;DE127;Neckar-Odenwald-Kreis;1032;251;113;1396
DE;3;DE128;Rhein-Neckar-Kreis;3687;992;447;5126
DE;3;DE129;Pforzheim, Stadtkreis;773;256;117;1146
DE;3;DE12A;Calw;1099;272;124;1495
DE;3;DE12B;Enzkreis;1409;309;141;1859
DE;3;DE12C;Freudenstadt;854;216;98;1168
DE;2;DE13;Freiburg;14760;3976;1809;20545
DE;3;DE131;Freiburg im Breisgau, Stadtkreis;1353;547;250;2150
DE;3;DE132;Breisgau-Hochschwarzwald;1719;429;196;2344
DE;3;DE133;Emmendingen;974;237;107;1318
DE;3;DE134;Ortenaukreis;2771;762;346;3879
DE;3;DE135;Rottweil;997;240;110;1347
DE;3;DE136;Schwarzwald-Baar-Kreis;1527;398;182;2107
DE;3;DE137;Tuttlingen;996;235;108;1339
DE;3;DE138;Konstanz;1839;491;223;2553
DE;3;DE139;Lörrach;1453;366;166;1985
DE;3;DE13A;Waldshut;1132;272;123;1527
DE;2;DE14;Tübingen;12561;3457;1573;17591
DE;3;DE141;Reutlingen;2040;553;253;2846
DE;3;DE142;Tübingen, Landkreis;1416;403;183;2002
DE;3;DE143;Zollernalbkreis;1396;325;148;1869
DE;3;DE144;Ulm, Stadtkreis;780;361;164;1305
DE;3;DE145;Alb-Donau-Kreis;1337;305;139;1781
DE;3;DE146;Biberach;1366;330;150;1846
DE;3;DE147;Bodenseekreis;1346;368;166;1880
DE;3;DE148;Ravensburg;1917;578;264;2759
DE;3;DE149;Sigmaringen;962;235;107;1304
DE;1;DE2;BAYERN;88676;26653;12082;127411
DE;2;DE21;Oberbayern;29619;10717;4866;45202
DE;3;DE211;Ingolstadt, Kreisfreie Stadt;825;288;131;1244
DE;3;DE212;München, Kreisfreie Stadt;8702;4305;1953;14960
DE;3;DE213;Rosenheim, Kreisfreie Stadt;397;150;68;615
DE;3;DE214;Altötting;766;183;83;1032
DE;3;DE215;Berchtesgadener Land;770;210;96;1076
DE;3;DE216;Bad Tölz-Wolfratshausen;824;213;97;1134
DE;3;DE217;Dachau;921;238;108;1267
DE;3;DE218;Ebersberg;876;236;108;1220
DE;3;DE219;Eichstätt;891;217;99;1207
DE;3;DE21A;Erding;857;231;105;1193
DE;3;DE21B;Freising;1091;381;173;1645
DE;3;DE21C;Fürstenfeldbruck;1395;351;160;1906
DE;3;DE21D;Garmisch-Partenkirchen;622;173;79;874
DE;3;DE21E;Landsberg am Lech;816;203;93;1112
DE;3;DE21F;Miesbach;690;185;84;959
DE;3;DE21G;Mühldorf a. Inn;747;184;84;1015
DE;3;DE21H;München, Landkreis;2105;1335;606;4046
DE;3;DE21I;Neuburg-Schrobenhausen;658;165;75;898
DE;3;DE21J;Pfaffenhofen a. d. Ilm;845;205;93;1143
DE;3;DE21K;Rosenheim, Landkreis;1722;442;201;2365
DE;3;DE21L;Starnberg;932;281;127;1340
DE;3;DE21M;Traunstein;1244;313;142;1699
DE;3;DE21N;Weilheim-Schongau;922;225;102;1249
DE;2;DE22;Niederbayern;8734;2173;985;11892
DE;3;DE221;Landshut, Kreisfreie Stadt;453;170;77;700
DE;3;DE222;Passau, Kreisfreie Stadt;359;149;67;575
DE;3;DE223;Straubing, Kreisfreie Stadt;312;114;51;477
DE;3;DE224;Deggendorf;879;221;101;1201
DE;3;DE225;Freyung-Grafenau;614;136;62;812
DE;3;DE226;Kelheim;813;189;86;1088
DE;3;DE227;Landshut, Landkreis;1080;237;108;1425
DE;3;DE228;Passau, Landkreis;1367;309;140;1816
DE;3;DE229;Regen;618;141;64;823
DE;3;DE22A;Rottal-Inn;869;207;94;1170
DE;3;DE22B;Straubing-Bogen;704;147;66;917
DE;3;DE22C;Dingolfing-Landau;667;153;69;889
DE;2;DE23;Oberpfalz;7936;2070;939;10945
DE;3;DE231;Amberg, Kreisfreie Stadt;307;97;44;448
DE;3;DE232;Regensburg, Kreisfreie Stadt;927;384;174;1485
DE;3;DE233;Weiden i. d. Opf, Kreisfreie Stadt;313;118;54;485
DE;3;DE234;Amberg-Sulzbach;787;168;76;1031
DE;3;DE235;Cham;956;227;103;1286
DE;3;DE236;Neumarkt i. d. OPf.;914;231;104;1249
DE;3;DE237;Neustadt a. d. Waldnaab;729;153;70;952
DE;3;DE238;Regensburg, Landkreis;1336;287;130;1753
DE;3;DE239;Schwandorf;1076;274;124;1474
DE;3;DE23A;Tirschenreuth;591;131;60;782
DE;2;DE24;Oberfranken;8158;2093;948;11199
DE;3;DE241;Bamberg, Kreisfreie Stadt;497;186;84;767
DE;3;DE242;Bayreuth, Kreisfreie Stadt;520;203;92;815
DE;3;DE243;Coburg, Kreisfreie Stadt;311;135;61;507
DE;3;DE244;Hof, Kreisfreie Stadt;359;125;57;541
DE;3;DE245;Bamberg, Landkreis;1020;226;102;1348
DE;3;DE246;Bayreuth, Landkreis;827;172;78;1077
DE;3;DE247;Coburg, Landkreis;667;138;63;868
DE;3;DE248;Forchheim;823;181;82;1086
DE;3;DE249;Hof, Landkreis;826;182;83;1091
DE;3;DE24A;Kronach;573;126;57;756
DE;3;DE24B;Kulmbach;580;136;61;777
DE;3;DE24C;Lichtenfels;516;137;62;715
DE;3;DE24D;Wunsiedel i. Fichtelgebirge;637;146;67;850
DE;2;DE25;Mittelfranken;12057;3593;1622;17272
DE;3;DE251;Ansbach, Kreisfreie Stadt;294;106;48;448
DE;3;DE252;Erlangen, Kreisfreie Stadt;723;291;131;1145
DE;3;DE253;Fürth, Kreisfreie Stadt;797;241;109;1147
DE;3;DE254;Nürnberg, Kreisfreie Stadt;3325;1340;605;5270
DE;3;DE255;Schwabach, Kreisfreie Stadt;278;77;35;390
DE;3;DE256;Ansbach, Landkreis;1319;298;135;1752
DE;3;DE257;Erlangen-Höchstadt;945;214;96;1255
DE;3;DE258;Fürth, Landkreis;832;189;85;1106
DE;3;DE259;Nürnberger Land;1234;294;133;1661
DE;3;DE25A;Neustadt a. d. Aisch-Bad Windsheim;716;165;75;956
DE;3;DE25B;Roth;909;215;97;1221
DE;3;DE25C;Weißenburg-Gunzenhausen;684;162;73;919
DE;2;DE26;Unterfranken;9359;2533;1144;13036
DE;3;DE261;Aschaffenburg, Kreisfreie Stadt;445;203;92;740
DE;3;DE262;Schweinfurt, Kreisfreie Stadt;351;135;61;547
DE;3;DE263;Würzburg, Kreisfreie Stadt;849;362;163;1374
DE;3;DE264;Aschaffenburg, Landkreis;1222;310;140;1672
DE;3;DE265;Bad Kissingen;770;193;87;1050
DE;3;DE266;Rhön-Grabfeld;601;146;66;813
DE;3;DE267;Haßberge;617;137;62;816
DE;3;DE268;Kitzingen;639;160;72;871
DE;3;DE269;Miltenberg;932;226;103;1261
DE;3;DE26A;Main-Spessart;951;206;93;1250
DE;3;DE26B;Schweinfurt, Landkreis;833;182;82;1097
DE;3;DE26C;Würzburg, Landkreis;1150;272;123;1545
DE;2;DE27;Schwaben;12814;3474;1577;17865
DE;3;DE271;Augsburg, Kreisfreie Stadt;1774;651;294;2719
DE;3;DE272;Kaufbeuren, Kreisfreie Stadt;300;95;43;438
DE;3;DE273;Kempten (Allgäu), Kreisfreie Stadt;463;188;86;737
DE;3;DE274;Memmingen, Kreisfreie Stadt;298;103;47;448
DE;3;DE275;Aichach-Friedberg;910;213;97;1220
DE;3;DE276;Augsburg, Landkreis;1698;404;183;2285
DE;3;DE277;Dillingen a.d. Donau;671;161;73;905
DE;3;DE278;Günzburg;867;225;102;1194
DE;3;DE279;Neu-Ulm;1161;295;134;1590
DE;3;DE27A;Lindau (Bodensee);573;146;67;786
DE;3;DE27B;Ostallgäu;1017;243;111;1371
DE;3;DE27C;Unterallgäu;1020;230;104;1354
DE;3;DE27D;Donau-Ries;941;241;109;1291
DE;3;DE27E;Oberallgäu;1123;280;128;1531
DE;1;DE3;BERLIN;21939;7459;3330;32728
DE;2;DE30;Berlin;21939;7459;3330;32728
DE;3;DE300;Berlin;21939;7459;3330;32728
DE;1;DE4;BRANDENBURG;17633;4497;2024;24154
DE;2;DE40;Brandenburg;17633;4497;2024;24154
DE;3;DE401;Brandenburg an der Havel, Kreisfreie Stadt;496;143;64;703
DE;3;DE402;Cottbus, Kreisfreie Stadt;670;226;101;997
DE;3;DE403;Frankfurt (Oder), Kreisfreie Stadt;393;137;62;592
DE;3;DE404;Potsdam, Kreisfreie Stadt;1027;405;182;1614
DE;3;DE405;Barnim;1241;293;132;1666
DE;3;DE406;Dahme-Spreewald;1139;354;159;1652
DE;3;DE407;Elbe-Elster;833;188;85;1106
DE;3;DE408;Havelland;1098;242;109;1449
DE;3;DE409;Märkisch-Oderland;1360;307;139;1806
DE;3;DE40A;Oberhavel;1449;357;161;1967
DE;3;DE40B;Oberspreewald-Lausitz;852;201;90;1143
DE;3;DE40C;Oder-Spree;1281;299;134;1714
DE;3;DE40D;Ostprignitz-Ruppin;754;176;79;1009
DE;3;DE40E;Potsdam-Mittelmark;1461;343;155;1959
DE;3;DE40F;Prignitz;632;141;64;837
DE;3;DE40G;Spree-Neiße;887;190;85;1162
DE;3;DE40H;Teltow-Fläming;1147;281;126;1554
DE;3;DE40I;Uckermark;914;215;97;1226
DE;1;DE5;BREMEN;4478;1576;718;6772
DE;2;DE50;Bremen;4478;1576;718;6772
DE;3;DE501;Bremen, Kreisfreie Stadt;3718;1314;598;5630
DE;3;DE502;Bremerhaven, Kreisfreie Stadt;760;262;120;1142
DE;1;DE6;HAMBURG;11118;5329;2428;18875
DE;2;DE60;Hamburg;11118;5329;2428;18875
DE;3;DE600;Hamburg;11118;5329;2428;18875
DE;1;DE7;HESSEN;42076;13611;6145;61832
DE;2;DE71;Darmstadt;25129;9188;4135;38452
DE;3;DE711;Darmstadt, Kreisfreie Stadt;922;409;184;1515
DE;3;DE712;Frankfurt am Main, Kreisfreie Stadt;4058;2677;1204;7939
DE;3;DE713;Offenbach am Main, Kreisfreie Stadt;680;253;113;1046
DE;3;DE714;Wiesbaden, Kreisfreie Stadt;1775;806;364;2945
DE;3;DE715;Bergstraße;1811;442;198;2451
DE;3;DE716;Darmstadt-Dieburg;1939;463;208;2610
DE;3;DE717;Groß-Gerau;1609;478;214;2301
DE;3;DE718;Hochtaunuskreis;1614;582;262;2458
DE;3;DE719;Main-Kinzig-Kreis;2938;754;342;4034
DE;3;DE71A;Main-Taunus-Kreis;1541;679;306;2526
DE;3;DE71B;Odenwaldkreis;708;157;71;936
DE;3;DE71C;Offenbach, Landkreis;2164;667;298;3129
DE;3;DE71D;Rheingau-Taunus-Kreis;1312;306;138;1756
DE;3;DE71E;Wetteraukreis;2058;514;232;2804
DE;2;DE72;Gießen;7643;1934;878;10455
DE;3;DE721;Gießen, Landkreis;1839;526;238;2603
DE;3;DE722;Lahn-Dill-Kreis;1888;461;209;2558
DE;3;DE723;Limburg-Weilburg;1261;305;138;1704
DE;3;DE724;Marburg-Biedenkopf;1787;453;206;2446
DE;3;DE725;Vogelsbergkreis;868;188;86;1142
DE;2;DE73;Kassel;9304;2489;1132;12925
DE;3;DE731;Kassel, Kreisfreie Stadt;1332;506;230;2068
DE;3;DE732;Fulda;1630;452;206;2288
DE;3;DE733;Hersfeld-Rotenburg;959;232;105;1296
DE;3;DE734;Kassel, Landkreis;1807;389;177;2373
DE;3;DE735;Schwalm-Eder-Kreis;1384;319;145;1848
DE;3;DE736;Waldeck-Frankenberg;1366;405;184;1955
DE;3;DE737;Werra-Meißner-Kreis;827;187;85;1099
DE;1;DE8;MECKLENBURG-VORPOMMERN;10722;2956;1346;15024
DE;2;DE80;Mecklenburg-Vorpommern;10722;2956;1346;15024
DE;3;DE803;Rostock, Kreisfreie Stadt;1234;424;193;1851
DE;3;DE804;Schwerin, Kreisfreie Stadt;588;201;91;880
DE;3;DE80J;Mecklenburgische Seenplatte;1607;532;242;2381
DE;3;DE80K;Landkreis Rostock;1432;358;163;1953
DE;3;DE80L;Vorpommern-Rügen;1507;387;178;2072
DE;3;DE80M;Nordwestmecklenburg;1037;242;110;1389
DE;3;DE80N;Vorpommern-Greifswald;1821;481;219;2521
DE;3;DE80O;Ludwigslust-Parchim;1496;330;150;1976
DE;1;DE9;NIEDERSACHSEN;56362;14414;6553;77329
DE;2;DE91;Braunschweig;11656;2964;1346;15966
DE;3;DE911;Braunschweig, Kreisfreie Stadt;1708;559;253;2520
DE;3;DE912;Salzgitter, Kreisfreie Stadt;671;177;80;928
DE;3;DE913;Wolfsburg, Kreisfreie Stadt;815;286;130;1231
DE;3;DE914;Gifhorn;1234;252;114;1600
DE;3;DE915;Göttingen;1830;523;237;2590
DE;3;DE916;Goslar;1150;273;125;1548
DE;3;DE917;Helmstedt;696;141;64;901
DE;3;DE918;Northeim;1085;234;107;1426
DE;3;DE919;Osterode am Harz;621;143;65;829
DE;3;DE91A;Peine;956;198;90;1244
DE;3;DE91B;Wolfenbüttel;891;179;81;1151
DE;2;DE92;Hannover;15145;4261;1934;21340
DE;3;DE922;Diepholz;1570;351;159;2080
DE;3;DE923;Hameln-Pyrmont;1149;276;125;1550
DE;3;DE925;Hildesheim;2034;478;217;2729
DE;3;DE926;Holzminden;596;120;55;771
DE;3;DE927;Nienburg (Weser);901;205;93;1199
DE;3;DE928;Schaumburg;1170;251;114;1535
DE;3;DE929;Region Hannover;7726;2582;1171;11479
DE;2;DE93;Lüneburg;12315;2862;1301;16478
DE;3;DE931;Celle;1313;309;140;1762
DE;3;DE932;Cuxhaven;1481;315;144;1940
DE;3;DE933;Harburg;1738;388;176;2302
DE;3;DE934;Lüchow-Dannenberg;392;80;36;508
DE;3;DE935;Lüneburg, Landkreis;1237;313;142;1692
DE;3;DE936;Osterholz;829;171;78;1078
DE;3;DE937;Rotenburg (Wümme);1219;299;136;1654
DE;3;DE938;Heidekreis;1009;257;117;1383
DE;3;DE939;Stade;1391;342;156;1889
DE;3;DE93A;Uelzen;728;166;75;969
DE;3;DE93B;Verden;977;222;101;1300
DE;2;DE94;Weser-Ems;17245;4326;1972;23543
DE;3;DE941;Delmenhorst, Kreisfreie Stadt;518;126;57;701
DE;3;DE942;Emden, Kreisfreie Stadt;352;106;48;506
DE;3;DE943;Oldenburg (Oldenburg), Kreisfreie Stadt;1130;378;172;1680
DE;3;DE944;Osnabrück, Kreisfreie Stadt;1077;390;177;1644
DE;3;DE945;Wilhelmshaven, Kreisfreie Stadt;568;167;76;811
DE;3;DE946;Ammerland;864;191;87;1142
DE;3;DE947;Aurich;1382;304;139;1825
DE;3;DE948;Cloppenburg;1053;247;113;1413
DE;3;DE949;Emsland;2109;527;240;2876
DE;3;DE94A;Friesland (DE);762;160;73;995
DE;3;DE94B;Grafschaft Bentheim;913;211;96;1220
DE;3;DE94C;Leer;1197;306;140;1643
DE;3;DE94D;Oldenburg, Landkreis;918;188;85;1191
DE;3;DE94E;Osnabrück, Landkreis;2430;550;249;3229
DE;3;DE94F;Vechta;886;240;109;1235
DE;3;DE94G;Wesermarsch;671;142;64;877
DE;3;DE94H;Wittmund;416;95;44;555
DE;1;DEA;NORDRHEIN-WESTFALEN;116263;34935;15820;167018
DE;2;DEA1;Düsseldorf;32422;10539;4757;47718
DE;3;DEA11;Düsseldorf, Kreisfreie Stadt;3692;2115;954;6761
DE;3;DEA12;Duisburg, Kreisfreie Stadt;2854;910;410;4174
DE;3;DEA13;Essen, Kreisfreie Stadt;3608;1292;585;5485
DE;3;DEA14;Krefeld, Kreisfreie Stadt;1409;413;185;2007
DE;3;DEA15;Mönchengladbach, Kreisfreie Stadt;1654;484;218;2356
DE;3;DEA16;Mülheim an der Ruhr,Kreisfreie Stadt;1081;349;157;1587
DE;3;DEA17;Oberhausen, Kreisfreie Stadt;1295;357;161;1813
DE;3;DEA18;Remscheid, Kreisfreie Stadt;737;202;92;1031
DE;3;DEA19;Solingen, Kreisfreie Stadt;1049;275;125;1449
DE;3;DEA1A;Wuppertal, Kreisfreie Stadt;2326;673;306;3305
DE;3;DEA1B;Kleve;2029;504;228;2761
DE;3;DEA1C;Mettmann;3035;905;407;4347
DE;3;DEA1D;Rhein-Kreis Neuss;2811;834;376;4021
DE;3;DEA1E;Viersen;1960;487;220;2667
DE;3;DEA1F;Wesel;2884;739;333;3956
DE;2;DEA2;Köln;28601;9114;4131;41846
DE;3;DEA22;Bonn, Kreisfreie Stadt;1999;1099;498;3596
DE;3;DEA23;Köln, Kreisfreie Stadt;6071;2661;1201;9933
DE;3;DEA24;Leverkusen, Kreisfreie Stadt;1049;312;142;1503
DE;3;DEA26;Düren;1772;428;194;2394
DE;3;DEA27;Rhein-Erft-Kreis;2980;795;360;4135
DE;3;DEA28;Euskirchen;1353;310;141;1804
DE;3;DEA29;Heinsberg;1669;385;175;2229
DE;3;DEA2A;Oberbergischer Kreis;1951;484;221;2656
DE;3;DEA2B;Rheinisch-Bergischer Kreis;1971;483;219;2673
DE;3;DEA2C;Rhein-Sieg-Kreis;3961;1045;473;5479
DE;3;DEA2D;Städteregion Aachen;3826;1112;507;5445
DE;2;DEA3;Münster;16687;4667;2115;23469
DE;3;DEA31;Bottrop, Kreisfreie Stadt;716;186;84;986
DE;3;DEA32;Gelsenkirchen, Kreisfreie Stadt;1547;458;207;2212
DE;3;DEA33;Münster, Kreisfreie Stadt;1919;853;388;3160
DE;3;DEA34;Borken;2360;612;278;3250
DE;3;DEA35;Coesfeld;1440;359;163;1962
DE;3;DEA36;Recklinghausen;3940;1005;453;5398
DE;3;DEA37;Steinfurt;2912;743;338;3993
DE;3;DEA38;Warendorf;1852;451;205;2508
DE;2;DEA4;Detmold;13978;3845;1745;19568
DE;3;DEA41;Bielefeld, Kreisfreie Stadt;2128;694;315;3137
DE;3;DEA42;Gütersloh;2296;676;307;3279
DE;3;DEA43;Herford;1778;438;199;2415
DE;3;DEA44;Höxter;1080;255;116;1451
DE;3;DEA45;Lippe;2503;616;280;3399
DE;3;DEA46;Minden-Lübbecke;2228;614;279;3121
DE;3;DEA47;Paderborn;1964;551;250;2765
DE;2;DEA5;Arnsberg;24575;6770;3073;34418
DE;3;DEA51;Bochum, Kreisfreie Stadt;2357;761;344;3462
DE;3;DEA52;Dortmund, Kreisfreie Stadt;3672;1232;558;5462
DE;3;DEA53;Hagen, Kreisfreie Stadt;1249;380;173;1802
DE;3;DEA54;Hamm, Kreisfreie Stadt;1142;321;146;1609
DE;3;DEA55;Herne, Kreisfreie Stadt;966;266;120;1352
DE;3;DEA56;Ennepe-Ruhr-Kreis;2258;569;259;3086
DE;3;DEA57;Hochsauerlandkreis;2085;507;232;2824
DE;3;DEA58;Märkischer Kreis;2926;726;330;3982
DE;3;DEA59;Olpe;1038;238;109;1385
DE;3;DEA5A;Siegen-Wittgenstein;2168;549;251;2968
DE;3;DEA5B;Soest;2104;534;243;2881
DE;3;DEA5C;Unna;2609;686;310;3605
DE;1;DEB;RHEINLAND-PFALZ;29053;7179;3244;39476
DE;2;DEB1;Koblenz;11108;2707;1230;15045
DE;3;DEB11;Koblenz, Kreisfreie Stadt;746;328;149;1223
DE;3;DEB12;Ahrweiler;970;220;100;1290
DE;3;DEB13;Altenkirchen (Westerwald);972;208;94;1274
DE;3;DEB14;Bad Kreuznach;1164;280;127;1571
DE;3;DEB15;Birkenfeld;660;145;66;871
DE;3;DEB16;Cochem-Zell;500;115;52;667
DE;3;DEB17;Mayen-Koblenz;1505;342;155;2002
DE;3;DEB18;Neuwied;1324;305;139;1768
DE;3;DEB19;Rhein-Hunsrück-Kreis;773;183;83;1039
DE;3;DEB1A;Rhein-Lahn-Kreis;939;205;93;1237
DE;3;DEB1B;Westerwaldkreis;1555;375;171;2101
DE;2;DEB2;Trier;3929;905;412;5246
DE;3;DEB21;Trier, Kreisfreie Stadt;729;241;110;1080
DE;3;DEB22;Bernkastel-Wittlich;852;183;83;1118
DE;3;DEB23;Eifelkreis Bitburg-Prüm;766;162;74;1002
DE;3;DEB24;Vulkaneifel;509;110;50;669
DE;3;DEB25;Trier-Saarburg;1073;209;95;1377
DE;2;DEB3;Rheinhessen-Pfalz;14016;3568;1601;19185
DE;3;DEB31;Frankenthal (Pfalz), Kreisfreie Stadt;295;78;35;408
DE;3;DEB32;Kaiserslautern, Kreisfreie Stadt;691;222;100;1013
DE;3;DEB33;Landau in der Pfalz, Kreisfreie Stadt;298;97;43;438
DE;3;DEB34;Ludwigshafen am Rhein, Kreisfreie Stadt;978;304;136;1418
DE;3;DEB35;Mainz, Kreisfreie Stadt;1263;550;247;2060
DE;3;DEB36;Neustadt an der Weinstraße, Kreisfreie Stadt;384;102;46;532
DE;3;DEB37;Pirmasens, Kreisfreie Stadt;303;85;38;426
DE;3;DEB38;Speyer, Kreisfreie Stadt;321;108;48;477
DE;3;DEB39;Worms, Kreisfreie Stadt;526;141;63;730
DE;3;DEB3A;Zweibrücken, Kreisfreie Stadt;259;68;31;358
DE;3;DEB3B;Alzey-Worms;876;198;89;1163
DE;3;DEB3C;Bad Dürkheim;985;205;92;1282
DE;3;DEB3D;Donnersbergkreis;568;116;53;737
DE;3;DEB3E;Germersheim;835;183;82;1100
DE;3;DEB3F;Kaiserslautern, Landkreis;817;164;74;1055
DE;3;DEB3G;Kusel;605;111;51;767
DE;3;DEB3H;Südliche Weinstraße;780;165;74;1019
DE;3;DEB3I;Rhein-Pfalz-Kreis;1042;210;94;1346
DE;3;DEB3J;Mainz-Bingen;1417;320;144;1881
DE;3;DEB3K;Südwestpfalz;771;140;63;974
DE;1;DEC;SAARLAND;7753;1886;854;10493
DE;2;DEC0;Saarland;7753;1886;854;10493
DE;3;DEC01;Regionalverband Saarbrücken;2407;731;330;3468
DE;3;DEC02;Merzig-Wadern;829;181;82;1092
DE;3;DEC03;Neunkirchen;1066;224;101;1391
DE;3;DEC04;Saarlouis;1539;332;150;2021
DE;3;DEC05;Saarpfalz-Kreis;1151;266;121;1538
DE;3;DEC06;St. Wendel;762;151;69;982
DE;1;DED;SACHSEN;28573;7539;3394;39506
DE;2;DED2;Dresden;10701;2844;1278;14823
DE;3;DED21;Dresden, Kreisfreie Stadt;3282;1097;492;4871
DE;3;DED2C;Bautzen;2105;508;228;2841
DE;3;DED2D;Görlitz;1921;440;198;2559
DE;3;DED2E;Meißen;1679;401;181;2261
DE;3;DED2F;Sächsische Schweiz-Osterzgebirge;1714;399;180;2293
DE;2;DED4;Chemnitz;11051;2779;1257;15087
DE;3;DED41;Chemnitz, Kreisfreie Stadt;1676;526;237;2439
DE;3;DED42;Erzgebirgskreis;2666;618;280;3564
DE;3;DED43;Mittelsachsen;2350;580;262;3192
DE;3;DED44;Vogtlandkreis;1876;438;199;2513
DE;3;DED45;Zwickau;2482;618;280;3380
DE;2;DED5;Leipzig;6820;1916;859;9595
DE;3;DED51;Leipzig, Kreisfreie Stadt;3552;1153;517;5222
DE;3;DED52;Leipzig;1857;419;188;2464
DE;3;DED53;Nordsachsen;1411;344;154;1909
DE;1;DEE;SACHSEN-ANHALT;16698;4065;1828;22591
DE;2;DEE0;Sachsen-Anhalt;16698;4065;1828;22591
DE;3;DEE01;Dessau-Roßlau, Kreisfreie Stadt;614;164;74;852
DE;3;DEE02;Halle (Saale), Kreisfreie Stadt;1547;484;217;2248
DE;3;DEE03;Magdeburg, Kreisfreie Stadt;1585;511;230;2326
DE;3;DEE04;Altmarkkreis Salzwedel;677;149;67;893
DE;3;DEE05;Anhalt-Bitterfeld;1264;291;131;1686
DE;3;DEE06;Jerichower Land;701;159;71;931
DE;3;DEE07;Börde;1314;290;131;1735
DE;3;DEE08;Burgenlandkreis;1377;312;140;1829
DE;3;DEE09;Harz;1679;375;169;2223
DE;3;DEE0A;Mansfeld-Südharz;1141;248;113;1502
DE;3;DEE0B;Saalekreis;1385;322;144;1851
DE;3;DEE0C;Salzlandkreis;1508;337;152;1997
DE;3;DEE0D;Stendal;894;204;92;1190
DE;3;DEE0E;Wittenberg;1012;219;98;1329
DE;1;DEF;SCHLESWIG-HOLSTEIN;19944;5293;2421;27658
DE;2;DEF0;Schleswig-Holstein;19944;5293;2421;27658
DE;3;DEF01;Flensburg, Kreisfreie Stadt;599;196;90;885
DE;3;DEF02;Kiel, Kreisfreie Stadt;1576;591;270;2437
DE;3;DEF03;Lübeck, Kreisfreie Stadt;1401;449;205;2055
DE;3;DEF04;Neumünster, Kreisfreie Stadt;529;167;76;772
DE;3;DEF05;Dithmarschen;1038;230;105;1373
DE;3;DEF06;Herzogtum Lauenburg;1318;305;139;1762
DE;3;DEF07;Nordfriesland;1237;319;147;1703
DE;3;DEF08;Ostholstein;1442;347;159;1948
DE;3;DEF09;Pinneberg;2051;520;238;2809
DE;3;DEF0A;Plön;926;200;92;1218
DE;3;DEF0B;Rendsburg-Eckernförde;1962;503;230;2695
DE;3;DEF0C;Schleswig-Flensburg;1475;336;155;1966
DE;3;DEF0D;Segeberg;1811;466;212;2489
DE;3;DEF0E;Steinburg;967;235;107;1309
DE;3;DEF0F;Stormarn;1612;428;195;2235
DE;1;DEG;THÜRINGEN;15361;3739;1694;20794
DE;2;DEG0;Thüringen;15361;3739;1694;20794
DE;3;DEG01;Erfurt, Kreisfreie Stadt;1323;438;198;1959
DE;3;DEG02;Gera, Kreisfreie Stadt;639;180;81;900
DE;3;DEG03;Jena, Kreisfreie Stadt;666;226;102;994
DE;3;DEG04;Suhl, Kreisfreie Stadt;256;75;34;365
DE;3;DEG05;Weimar, Kreisfreie Stadt;423;125;57;605
DE;3;DEG06;Eichsfeld;693;158;72;923
DE;3;DEG07;Nordhausen;642;148;68;858
DE;3;DEG09;Unstrut-Hainich-Kreis;739;170;77;986
DE;3;DEG0A;Kyffhäuserkreis;569;121;55;745
DE;3;DEG0B;Schmalkalden-Meiningen;933;209;95;1237
DE;3;DEG0C;Gotha;974;225;102;1301
DE;3;DEG0D;Sömmerda;496;105;47;648
DE;3;DEG0E;Hildburghausen;473;103;47;623
DE;3;DEG0F;Ilm-Kreis;813;190;86;1089
DE;3;DEG0G;Weimarer Land;592;129;58;779
DE;3;DEG0H;Sonneberg;449;96;44;589
DE;3;DEG0I;Saalfeld-Rudolstadt;820;184;84;1088
DE;3;DEG0J;Saale-Holzland-Kreis;593;134;61;788
DE;3;DEG0K;Saale-Orla-Kreis;639;141;64;844
DE;3;DEG0L;Greiz;756;160;72;988
DE;3;DEG0M;Altenburger Land;669;149;67;885
DE;3;DEG0N;Eisenach, Kreisfreie Stadt;298;80;36;414
DE;3;DEG0P;Wartburgkreis;906;193;88;1187
DE;1;DEZ;EXTRA-REGIO NUTS 1;;;;0
DE;2;DEZZ;Extra-Regio NUTS 2;;;;0
DE;3;DEZZZ;Extra-Regio NUTS 3;;;;0
EE;0;EE;EESTI;10130;2031;1110;13271
EE;1;EE0;EESTI;10130;2031;1110;13271
EE;2;EE00;Eesti;10130;2031;1110;13271
EE;3;EE001;Põhja-Eesti;3841;1277;679;5797
EE;3;EE004;Lääne-Eesti;1333;149;74;1556
EE;3;EE006;Kesk-Eesti;1181;119;63;1363
EE;3;EE007;Kirde-Eesti;964;135;75;1174
EE;3;EE008;Lõuna-Eesti;2810;350;219;3379
EE;1;EEZ;EXTRA-REGIO NUTS 1;;;;0
EE;2;EEZZ;Extra-Regio NUTS 2;;;;0
EE;3;EEZZZ;Extra-Regio NUTS 3;;;;0
IE;0;IE;IRELAND;25138;6836;2853;34827
IE;1;IE0;IRELAND;25138;6836;2853;34827
IE;2;IE01;Border, Midland and Western;7128;1170;596;8894
IE;3;IE011;Border;3080;458;238;3776
IE;3;IE012;Midland;1524;270;132;1926
IE;3;IE013;West;2523;442;226;3191
IE;2;IE02;Southern and Eastern;18010;5666;2256;25932
IE;3;IE021;Dublin;6787;3322;1200;11309
IE;3;IE022;Mid-East;2676;585;249;3510
IE;3;IE023;Mid-West;2045;438;193;2676
IE;3;IE024;South-East (IE);2746;496;231;3473
IE;3;IE025;South-West (IE);3755;824;384;4963
IE;1;IEZ;EXTRA-REGIO NUTS 1;;;;0
IE;2;IEZZ;Extra-Regio NUTS 2;;;;0
IE;3;IEZZZ;Extra-Regio NUTS 3;;;;0
EL;0;EL;?????? (ELLADA);51157;8199;1248;60604
EL;1;EL3;ATTIK? (ATTIKI);15233;2424;325;17982
EL;2;EL30;A????? (Attiki);15233;2424;325;17982
EL;3;EL301;??????? ?????? ?????? (Voreios Tomeas Athinon);2486;379;52;2917
EL;3;EL302;??????? ?????? ?????? (Dytikos Tomeas Athinon);2162;294;44;2500
EL;3;EL303;????????? ?????? ?????? (Kentrikos Tomeas Athinon);3859;640;84;4583
EL;3;EL304;?????? ?????? ?????? (Notios Tomeas Athinon);2110;350;46;2506
EL;3;EL305;????????? ?????? (Anatoliki Attiki);2132;354;46;2532
EL;3;EL306;?????? ?????? (Dytiki Attiki);777;103;15;895
EL;3;EL307;????????, ????? (Peiraias, Nisoi);1707;305;39;2051
EL;1;EL4;N???? ???????, K???? (NISIA AIGAIOU, KRITI);5116;1315;143;6574
EL;2;EL41;?????? ?????? (Voreio Aigaio);1069;185;29;1283
EL;3;EL411;??????, ?????? (Lesvos, Limnos);539;90;15;644
EL;3;EL412;??????, ????? (Ikaria, Samos);227;45;6;278
EL;3;EL413;???? (Chios);303;49;8;360
EL;2;EL42;????? ?????? (Notio Aigaio);1343;553;40;1936
EL;3;EL421;????????, ????????, ???, ????? (Kalymnos, Karpathos, Kos, Rodos);684;300;25;1009
EL;3;EL422;??????, ????, ???, ?????, ???????, ?????, ?????, ?????, ????? (Andros, Thira, Kea, Milos, Mykonos, Naxos, Paros,  Syros, Tinos);659;252;15;926
EL;2;EL43;????? (Kriti);2705;578;74;3357
EL;3;EL431;???????? (Irakleio);1191;283;37;1511
EL;3;EL432;?????? (Lasithi);439;79;8;526
EL;3;EL433;??????? (Rethymni);375;76;9;460
EL;3;EL434;????? (Chania);699;140;20;859
EL;1;EL5;?????? ?????? (VOREIA ELLADA);16776;2245;445;19466
EL;2;EL51;A???????? ?????????, ????? (Anatoliki Makedonia, Thraki);3307;381;89;3777
EL;3;EL511;????? (Evros);820;84;29;933
EL;3;EL512;????? (Xanthi);540;63;16;619
EL;3;EL513;?????? (Rodopi);561;57;16;634
EL;3;EL514;????? (Drama);572;43;12;627
EL;3;EL515;?????, ?????? (Thasos, Kavala);814;134;16;964
EL;2;EL52;???????? ????????? (Kentriki Makedonia);9999;1515;277;11791
EL;3;EL521;?????? (Imathia);661;87;15;763
EL;3;EL522;??????????? (Thessaloniki);5460;954;194;6608
EL;3;EL523;?????? (Kilkis);426;50;9;485
EL;3;EL524;????? (Pella);630;98;14;742
EL;3;EL525;?????? (Pieria);735;85;16;836
EL;3;EL526;?????? (Serres);892;117;17;1026
EL;3;EL527;????????? (Chalkidiki);1196;124;11;1331
EL;2;EL53;?????? ????????? (Dytiki Makedonia);1623;128;35;1786
EL;3;EL531;???????, ?????? (Grevena, Kozani);1036;85;21;1142
EL;3;EL532;???????? (Kastoria);278;23;6;307
EL;3;EL533;??????? (Florina);309;20;7;336
EL;2;EL54;??????? (Ipeiros);1847;221;44;2112
EL;3;EL541;????, ??????? (Arta, Preveza);558;94;13;665
EL;3;EL542;????????? (Thesprotia);215;46;5;266
EL;3;EL543;???????? (Ioannina);1074;81;26;1181
EL;1;EL6;???????? ?????? (KENTRIKI ELLADA);14032;2215;335;16582
EL;2;EL61;???????? (Thessalia);3343;530;94;3967
EL;3;EL611;????????, ??????? (Karditsa, Trikala);1166;144;27;1337
EL;3;EL612;?????? (Larisa);1198;203;40;1441
EL;3;EL613;????????, ???????? (Magnisia, Sporades);978;183;27;1188
EL;2;EL62;????? ????? (Ionia Nisia);1086;270;25;1381
EL;3;EL621;???????? (Zakynthos);125;65;4;194
EL;3;EL622;??????? (Kerkyra);652;122;15;789
EL;3;EL623;?????, ?????????? (Ithaki, Kefallinia);172;55;3;230
EL;3;EL624;??????? (Lefkada);137;28;3;168
EL;2;EL63;?????? ?????? (Dytiki Ellada);3256;503;86;3845
EL;3;EL631;??????????????? (Aitoloakarnania);886;174;21;1081
EL;3;EL632;????? (Achaia);1669;223;49;1941
EL;3;EL633;????? (Ileia);701;107;16;824
EL;2;EL64;?????? ?????? (Sterea Ellada);2896;434;60;3390
EL;3;EL641;??????? (Voiotia);517;85;11;613
EL;3;EL642;?????? (Evvoia);1181;180;23;1384
EL;3;EL643;????????? (Evrytania);151;12;3;166
EL;3;EL644;???????? (Fthiotida);755;135;18;908
EL;3;EL645;?????? (Fokida);293;23;5;321
EL;2;EL65;???????????? (Peloponnisos);3451;477;70;3998
EL;3;EL651;????????, ??????? (Argolida, Arkadia);1173;148;23;1344
EL;3;EL652;???????? (Korinthia);773;125;16;914
EL;3;EL653;???????, ???????? (Lakonia, Messinia);1505;204;31;1740
EL;1;ELZ;EXTRA-REGIO NUTS 1;;;;0
EL;2;ELZZ;Extra-Regio NUTS 2;;;;0
EL;3;ELZZZ;Extra-Regio NUTS 3;;;;0
ES;0;ES;ESPAÑA ;107769;53232;12584;173585
ES;1;ES1;NOROESTE;10824;2963;1088;14875
ES;2;ES11;Galicia;6825;1809;671;9305
ES;3;ES111;A Coruña;2746;738;296;3780
ES;3;ES112;Lugo;945;228;85;1258
ES;3;ES113;Ourense;964;224;85;1273
ES;3;ES114;Pontevedra;2171;619;204;2994
ES;2;ES12;Principado de Asturias;2566;774;269;3609
ES;3;ES120;Asturias;2566;774;269;3609
ES;2;ES13;Cantabria;1433;379;148;1960
ES;3;ES130;Cantabria;1433;379;148;1960
ES;1;ES2;NORESTE;10685;4437;1389;16511
ES;2;ES21;País Vasco;4935;2092;695;7722
ES;3;ES211;Araba/Álava;793;293;120;1206
ES;3;ES212;Gipuzkoa;1555;668;220;2443
ES;3;ES213;Bizkaia;2587;1131;355;4073
ES;2;ES22;Comunidad Foral de Navarra;1541;595;198;2334
ES;3;ES220;Navarra;1541;595;198;2334
ES;2;ES23;La Rioja;815;267;86;1168
ES;3;ES230;La Rioja;815;267;86;1168
ES;2;ES24;Aragón;3393;1483;409;5285
ES;3;ES241;Huesca;676;199;73;948
ES;3;ES242;Teruel;460;114;51;625
ES;3;ES243;Zaragoza;2257;1170;285;3712
ES;1;ES3;COMUNIDAD DE MADRID;14360;12473;2309;29142
ES;2;ES30;Comunidad de Madrid;14360;12473;2309;29142
ES;3;ES300;Madrid;14360;12473;2309;29142
ES;1;ES4;CENTRO (ES);15134;4880;1560;21574
ES;2;ES41;Castilla y León;7060;2103;767;9930
ES;3;ES411;Ávila;524;140;50;714
ES;3;ES412;Burgos;1068;290;115;1473
ES;3;ES413;León;1450;395;145;1990
ES;3;ES414;Palencia;479;124;53;656
ES;3;ES415;Salamanca;910;282;107;1299
ES;3;ES416;Segovia;455;144;49;648
ES;3;ES417;Soria;278;76;30;384
ES;3;ES418;Valladolid;1359;508;170;2037
ES;3;ES419;Zamora;536;143;50;729
ES;2;ES42;Castilla-La Mancha;5444;1826;527;7797
ES;3;ES421;Albacete;1035;355;114;1504
ES;3;ES422;Ciudad Real;1327;490;129;1946
ES;3;ES423;Cuenca;632;181;57;870
ES;3;ES424;Guadalajara;715;189;68;972
ES;3;ES425;Toledo;1735;611;159;2505
ES;2;ES43;Extremadura;2630;951;266;3847
ES;3;ES431;Badajoz;1610;613;168;2391
ES;3;ES432;Cáceres;1019;337;98;1454
ES;1;ES5;ESTE;31423;15960;3498;50881
ES;2;ES51;Cataluña;17531;9729;2143;29403
ES;3;ES511;Barcelona;12515;7290;1587;21392
ES;3;ES512;Girona;1893;912;202;3007
ES;3;ES513;Lleida;1223;492;147;1862
ES;3;ES514;Tarragona;1900;1034;207;3141
ES;2;ES52;Comunidad Valenciana;11556;4700;1098;17354
ES;3;ES521;Alicante / Alacant;4162;1577;374;6113
ES;3;ES522;Castellón / Castelló;1502;509;135;2146
ES;3;ES523;Valencia / València;5893;2615;589;9097
ES;2;ES53;Illes Balears;2336;1531;257;4124
ES;3;ES531;Eivissa y Formentera;222;212;19;453
ES;3;ES532;Mallorca;1905;1218;220;3343
ES;3;ES533;Menorca;208;100;18;326
ES;1;ES6;SUR;20768;9595;2199;32562
ES;2;ES61;Andalucía;17529;8023;1832;27384
ES;3;ES611;Almería;1570;625;143;2338
ES;3;ES612;Cádiz;2335;1043;258;3636
ES;3;ES613;Córdoba;1659;761;171;2591
ES;3;ES614;Granada;2357;819;243;3419
ES;3;ES615;Huelva;1059;463;105;1627
ES;3;ES616;Jaén;1543;595;151;2289
ES;3;ES617;Málaga;3343;1587;345;5275
ES;3;ES618;Sevilla;3662;2131;416;6209
ES;2;ES62;Región de Murcia;3012;1445;319;4776
ES;3;ES620;Murcia;3012;1445;319;4776
ES;2;ES63;Ciudad Autónoma de Ceuta;108;60;23;191
ES;3;ES630;Ceuta;108;60;23;191
ES;2;ES64;Ciudad Autónoma de Melilla;119;67;25;211
ES;3;ES640;Melilla;119;67;25;211
ES;1;ES7;CANARIAS;4576;2925;542;8043
ES;2;ES70;Canarias;4576;2925;542;8043
ES;3;ES703;El Hierro;26;10;3;39
ES;3;ES704;Fuerteventura;159;130;13;302
ES;3;ES705;Gran Canaria;1853;1160;220;3233
ES;3;ES706;La Gomera;52;27;6;85
ES;3;ES707;La Palma;197;100;23;320
ES;3;ES708;Lanzarote;316;220;33;569
ES;3;ES709;Tenerife;1973;1278;243;3494
ES;1;ESZ;EXTRA-REGIO NUTS 1;;;;0
ES;2;ESZZ;Extra-Regio NUTS 2;;;;0
ES;3;ESZZZ;Extra-Regio NUTS 3;;;;0
FR;0;FR;FRANCE;373113;77867;64229;515209
FR;1;FR1;ÎLE DE FRANCE;61210;24696;18743;104649
FR;2;FR10;Île de France;61210;24696;18743;104649
FR;3;FR101;Paris;13213;8358;6252;27823
FR;3;FR102;Seine-et-Marne;6851;1586;1187;9624
FR;3;FR103;Yvelines;7262;1881;1538;10681
FR;3;FR104;Essonne;6315;1509;1461;9285
FR;3;FR105;Hauts-de-Seine;7993;5335;3986;17314
FR;3;FR106;Seine-Saint-Denis;7091;2101;1682;10874
FR;3;FR107;Val-de-Marne;6660;2339;1562;10561
FR;3;FR108;Val-d'Oise;5825;1587;1075;8487
FR;1;FR2;BASSIN PARISIEN;67521;9824;9041;86386
FR;2;FR21;Champagne-Ardenne;8612;1242;1134;10988
FR;3;FR211;Ardennes;1920;214;216;2350
FR;3;FR212;Aube;1907;278;242;2427
FR;3;FR213;Marne;3465;590;531;4586
FR;3;FR214;Haute-Marne;1320;159;145;1624
FR;2;FR22;Picardie;11599;1654;1565;14818
FR;3;FR221;Aisne;3435;441;406;4282
FR;3;FR222;Oise;4540;733;660;5933
FR;3;FR223;Somme;3624;480;499;4603
FR;2;FR23;Haute-Normandie;10910;1609;1583;14102
FR;3;FR231;Eure;3420;441;420;4281
FR;3;FR232;Seine-Maritime;7490;1168;1163;9821
FR;2;FR24;Centre;15915;2443;2107;20465
FR;3;FR241;Cher;2122;281;235;2638
FR;3;FR242;Eure-et-Loir;2632;382;330;3344
FR;3;FR243;Indre;1610;199;167;1976
FR;3;FR244;Indre-et-Loire;3471;594;505;4570
FR;3;FR245;Loir-et-Cher;2123;290;255;2668
FR;3;FR246;Loiret;3957;696;615;5268
FR;2;FR25;Basse-Normandie;9488;1246;1205;11939
FR;3;FR251;Calvados;4258;698;635;5591
FR;3;FR252;Manche;3185;333;345;3863
FR;3;FR253;Orne;2045;215;225;2485
FR;2;FR26;Bourgogne;10997;1630;1447;14074
FR;3;FR261;Côte-d'Or;3400;615;571;4586
FR;3;FR262;Nièvre;1679;190;174;2043
FR;3;FR263;Saône-et-Loire;3663;514;439;4616
FR;3;FR264;Yonne;2256;312;262;2830
FR;1;FR3;NORD - PAS-DE-CALAIS;23784;3628;3616;31028
FR;2;FR30;Nord - Pas-de-Calais;23784;3628;3616;31028
FR;3;FR301;Nord;14970;2512;2506;19988
FR;3;FR302;Pas-de-Calais;8813;1116;1110;11039
FR;1;FR4;EST;33106;5077;4620;42803
FR;2;FR41;Lorraine;14911;2142;1995;19048
FR;3;FR411;Meurthe-et-Moselle;4604;758;698;6060
FR;3;FR412;Meuse;1313;140;142;1595
FR;3;FR413;Moselle;6334;937;857;8128
FR;3;FR414;Vosges;2661;306;298;3265
FR;2;FR42;Alsace;10602;1899;1652;14153
FR;3;FR421;Bas-Rhin;6070;1214;1029;8313
FR;3;FR422;Haut-Rhin;4532;684;623;5839
FR;2;FR43;Franche-Comté;7594;1036;974;9604
FR;3;FR431;Doubs;3452;496;499;4447
FR;3;FR432;Jura;1677;225;186;2088
FR;3;FR433;Haute-Saône;1578;177;154;1909
FR;3;FR434;Territoire de Belfort;887;138;135;1160
FR;1;FR5;OUEST;50666;7857;6784;65307
FR;2;FR51;Pays de la Loire;20447;3508;2877;26832
FR;3;FR511;Loire-Atlantique;7101;1402;1181;9684
FR;3;FR512;Maine-et-Loire;4329;685;610;5624
FR;3;FR513;Mayenne;1833;270;232;2335
FR;3;FR514;Sarthe;3411;622;437;4470
FR;3;FR515;Vendée;3773;529;416;4718
FR;2;FR52;Bretagne;19288;2719;2528;24535
FR;3;FR521;Côtes-d'Armor;3955;432;427;4814
FR;3;FR522;Finistère;5623;704;686;7013
FR;3;FR523;Ille-et-Vilaine;5379;1022;920;7321
FR;3;FR524;Morbihan;4330;562;494;5386
FR;2;FR53;Poitou-Charentes;10931;1630;1379;13940
FR;3;FR531;Charente;2161;323;250;2734
FR;3;FR532;Charente-Maritime;3861;559;452;4872
FR;3;FR533;Deux-Sèvres;2272;366;288;2926
FR;3;FR534;Vienne;2638;382;388;3408
FR;1;FR6;SUD-OUEST;40673;6970;5926;53569
FR;2;FR61;Aquitaine;18113;3348;2698;24159
FR;3;FR611;Dordogne;2692;335;289;3316
FR;3;FR612;Gironde;7828;1696;1371;10895
FR;3;FR613;Landes;2154;343;247;2744
FR;3;FR614;Lot-et-Garonne;1938;302;232;2472
FR;3;FR615;Pyrénées-Atlantiques;3501;671;559;4731
FR;2;FR62;Midi-Pyrénées;17251;2983;2599;22833
FR;3;FR621;Ariège;1237;116;119;1472
FR;3;FR622;Aveyron;2085;245;214;2544
FR;3;FR623;Haute-Garonne;6410;1595;1387;9392
FR;3;FR624;Gers;1166;148;133;1447
FR;3;FR625;Lot;1239;145;126;1510
FR;3;FR626;Hautes-Pyrénées;1600;210;192;2002
FR;3;FR627;Tarn;2163;316;265;2744
FR;3;FR628;Tarn-et-Garonne;1351;209;162;1722
FR;2;FR63;Limousin;5309;639;629;6577
FR;3;FR631;Corrèze;1803;215;208;2226
FR;3;FR632;Creuse;1021;89;91;1201
FR;3;FR633;Haute-Vienne;2485;335;331;3151
FR;1;FR7;CENTRE-EST;47260;8567;7385;63212
FR;2;FR71;Rhône-Alpes;37190;7294;6141;50625
FR;3;FR711;Ain;3312;553;403;4268
FR;3;FR712;Ardèche;2307;236;230;2773
FR;3;FR713;Drôme;2859;521;398;3778
FR;3;FR714;Isère;6928;1256;1202;9386
FR;3;FR715;Loire;4307;706;635;5648
FR;3;FR716;Rhône;8750;2683;2139;13572
FR;3;FR717;Savoie;3227;531;433;4191
FR;3;FR718;Haute-Savoie;5501;807;699;7007
FR;2;FR72;Auvergne;10070;1273;1245;12588
FR;3;FR721;Allier;2502;302;277;3081
FR;3;FR722;Cantal;1341;127;132;1600
FR;3;FR723;Haute-Loire;1750;178;164;2092
FR;3;FR724;Puy-de-Dôme;4478;667;671;5816
FR;1;FR8;MÉDITERRANÉE;45476;9248;7228;61952
FR;2;FR81;Languedoc-Roussillon;15735;2660;2160;20555
FR;3;FR811;Aude;2170;319;240;2729
FR;3;FR812;Gard;3828;662;513;5003
FR;3;FR813;Hérault;5466;1185;935;7586
FR;3;FR814;Lozère;744;63;75;882
FR;3;FR815;Pyrénées-Orientales;3527;432;397;4356
FR;2;FR82;Provence-Alpes-Côte d'Azur;28287;6299;4852;39438
FR;3;FR821;Alpes-de-Haute-Provence;1436;148;156;1740
FR;3;FR822;Hautes-Alpes;1323;149;141;1613
FR;3;FR823;Alpes-Maritimes;6939;1470;1210;9619
FR;3;FR824;Bouches-du-Rhône;9729;2713;2093;14535
FR;3;FR825;Var;5655;1141;774;7570
FR;3;FR826;Vaucluse;3205;679;477;4361
FR;2;FR83;Corse;1455;289;216;1960
FR;3;FR831;Corse-du-Sud;586;145;100;831
FR;3;FR832;Haute-Corse;869;143;116;1128
FR;1;FRA;DÉPARTEMENTS D'OUTRE-MER;3416;1973;823;6212
FR;2;FRA1;Guadeloupe;1319;248;218;1785
FR;3;FRA10;Guadeloupe;1319;248;218;1785
FR;2;FRA2;Martinique;1022;234;188;1444
FR;3;FRA20;Martinique;1022;234;188;1444
FR;2;FRA3;Guyane;180;244;69;493
FR;3;FRA30;Guyane;180;244;69;493
FR;2;FRA4;La Réunion;683;920;261;1864
FR;3;FRA40;La Réunion;683;920;261;1864
FR;2;FRA5;Mayotte;213;327;87;627
FR;3;FRA50;Mayotte;213;327;87;627
FR;1;FRZ;EXTRA-REGIO NUTS 1;;;;0
FR;2;FRZZ;Extra-Regio NUTS 2;;;;0
FR;3;FRZZZ;Extra-Regio NUTS 3;;;;0
HR;0;HR;HRVATSKA;14861;2481;883;18225
HR;1;HR0;HRVATSKA;14861;2481;883;18225
HR;2;HR03;Jadranska Hrvatska;5486;811;244;6541
HR;3;HR031;Primorsko-goranska županija;1197;192;58;1447
HR;3;HR032;Li?ko-senjska županija;316;22;9;347
HR;3;HR033;Zadarska županija;770;86;29;885
HR;3;HR034;Šibensko-kninska županija;513;52;16;581
HR;3;HR035;Splitsko-dalmatinska županija;1470;225;70;1765
HR;3;HR036;Istarska županija;839;151;41;1031
HR;3;HR037;Dubrova?ko-neretvanska županija;380;84;21;485
HR;2;HR04;Kontinentalna Hrvatska;9376;1670;639;11685
HR;3;HR041;Grad Zagreb;2923;887;337;4147
HR;3;HR042;Zagreba?ka županija;952;152;40;1144
HR;3;HR043;Krapinsko-zagorska županija;428;43;17;488
HR;3;HR044;Varaždinska županija;535;69;29;633
HR;3;HR045;Koprivni?ko-križeva?ka županija;360;42;16;418
HR;3;HR046;Me?imurska županija;308;44;16;368
HR;3;HR047;Bjelovarsko-bilogorska županija;383;40;17;440
HR;3;HR048;Viroviti?ko-podravska županija;254;25;10;289
HR;3;HR049;Požeško-slavonska županija;239;25;11;275
HR;3;HR04A;Brodsko-posavska županija;435;48;20;503
HR;3;HR04B;Osje?ko-baranjska županija;970;132;53;1155
HR;3;HR04C;Vukovarsko-srijemska županija;519;59;25;603
HR;3;HR04D;Karlova?ka županija;459;47;23;529
HR;3;HR04E;Sisa?ko-moslava?ka županija;608;57;25;690
HR;1;HRZ;EXTRA-REGIO NUTS 1;;;;0
HR;2;HRZZ;Extra-Regio NUTS 2;;;;0
HR;3;HRZZZ;Extra-Regio NUTS 3;;;;0
IT;0;IT;ITALIA ;365218;84624;32161;482003
IT;1;ITC;NORD-OVEST;105632;26865;9810;142307
IT;2;ITC1;Piemonte;30633;6179;2493;39305
IT;3;ITC11;Torino;15516;3381;1441;20338
IT;3;ITC12;Vercelli;1309;221;94;1624
IT;3;ITC13;Biella;1492;241;95;1828
IT;3;ITC14;Verbano-Cusio-Ossola;1421;207;96;1724
IT;3;ITC15;Novara;2471;462;176;3109
IT;3;ITC16;Cuneo;3934;762;292;4988
IT;3;ITC17;Asti;1506;259;95;1860
IT;3;ITC18;Alessandria;2984;647;204;3835
IT;2;ITC2;Valle d'Aosta/Vallée d'Aoste;1019;264;110;1393
IT;3;ITC20;Valle d'Aosta/Vallée d'Aoste;1019;264;110;1393
IT;2;ITC3;Liguria;10086;2584;942;13612
IT;3;ITC31;Imperia;1152;265;92;1509
IT;3;ITC32;Savona;1723;387;134;2244
IT;3;ITC33;Genova;6012;1611;592;8215
IT;3;ITC34;La Spezia;1199;321;125;1645
IT;2;ITC4;Lombardia;63894;17838;6265;87997
IT;3;ITC41;Varese;5827;1209;445;7481
IT;3;ITC42;Como;4065;842;312;5219
IT;3;ITC43;Lecco;2265;405;160;2830
IT;3;ITC44;Sondrio;2013;394;156;2563
IT;3;ITC46;Bergamo;8394;1476;626;10496
IT;3;ITC47;Brescia;8457;1716;662;10835
IT;3;ITC48;Pavia;3563;651;255;4469
IT;3;ITC49;Lodi;1337;300;98;1735
IT;3;ITC4A;Cremona;2335;482;171;2988
IT;3;ITC4B;Mantova;2733;545;184;3462
IT;3;ITC4C;Milano;18002;8658;2794;29454
IT;3;ITC4D;Monza e della Brianza;4903;1161;401;6465
IT;1;ITF;SUD;71720;13463;5474;90657
IT;2;ITF1;Abruzzo;8005;1435;645;10085
IT;3;ITF11;L'Aquila;2149;324;193;2666
IT;3;ITF12;Teramo;1917;330;135;2382
IT;3;ITF13;Pescara;1778;383;158;2319
IT;3;ITF14;Chieti;2161;398;159;2718
IT;2;ITF2;Molise;2001;295;149;2445
IT;3;ITF21;Isernia;597;78;43;718
IT;3;ITF22;Campobasso;1404;217;106;1727
IT;2;ITF3;Campania;27592;5624;2236;35452
IT;3;ITF31;Caserta;4329;739;304;5372
IT;3;ITF32;Benevento;1734;236;113;2083
IT;3;ITF33;Napoli;13057;3286;1225;17568
IT;3;ITF34;Avellino;2843;361;182;3386
IT;3;ITF35;Salerno;5629;1002;413;7044
IT;2;ITF4;Puglia;21024;3840;1527;26391
IT;3;ITF43;Taranto;3163;504;231;3898
IT;3;ITF44;Brindisi;2086;358;140;2584
IT;3;ITF45;Lecce;4245;702;257;5204
IT;3;ITF46;Foggia;3217;565;232;4014
IT;3;ITF47;Bari;6436;1377;536;8349
IT;3;ITF48;Barletta-Andria-Trani;1877;333;131;2341
IT;2;ITF5;Basilicata;3120;475;225;3820
IT;3;ITF51;Potenza;2272;321;164;2757
IT;3;ITF52;Matera;848;154;61;1063
IT;2;ITF6;Calabria;9978;1794;691;12463
IT;3;ITF61;Cosenza;3402;674;229;4305
IT;3;ITF62;Crotone;727;130;49;906
IT;3;ITF63;Catanzaro;1690;330;138;2158
IT;3;ITF64;Vibo Valentia;929;138;59;1126
IT;3;ITF65;Reggio di Calabria;3231;522;217;3970
IT;1;ITG;ISOLE;34199;6518;2591;43308
IT;2;ITG1;Sicilia;25643;4926;1934;32503
IT;3;ITG11;Trapani;1863;363;128;2354
IT;3;ITG12;Palermo;6884;1274;575;8733
IT;3;ITG13;Messina;3620;632;279;4531
IT;3;ITG14;Agrigento;2841;425;172;3438
IT;3;ITG15;Caltanissetta;1398;238;97;1733
IT;3;ITG16;Enna;970;148;67;1185
IT;3;ITG17;Catania;4423;1161;356;5940
IT;3;ITG18;Ragusa;1727;336;113;2176
IT;3;ITG19;Siracusa;1916;350;147;2413
IT;2;ITG2;Sardegna;8556;1592;657;10805
IT;3;ITG25;Sassari;1777;325;135;2237
IT;3;ITG26;Nuoro;914;128;64;1106
IT;3;ITG27;Cagliari;2662;586;254;3502
IT;3;ITG28;Oristano;985;133;59;1177
IT;3;ITG29;Olbia-Tempio;774;199;59;1032
IT;3;ITG2A;Ogliastra;296;47;20;363
IT;3;ITG2B;Medio Campidano;516;77;26;619
IT;3;ITG2C;Carbonia-Iglesias;631;96;39;766
IT;1;ITH;NORD-EST;83695;19100;7071;109866
IT;2;ITH1;Provincia Autonoma di Bolzano/Bozen;4236;1099;496;5831
IT;3;ITH10;Bolzano-Bozen;4236;1099;496;5831
IT;2;ITH2;Provincia Autonoma di Trento;4251;927;434;5612
IT;3;ITH20;Trento;4251;927;434;5612
IT;2;ITH3;Veneto;34889;7859;2699;45447
IT;3;ITH31;Verona;6295;1617;514;8426
IT;3;ITH32;Vicenza;6034;1213;410;7657
IT;3;ITH33;Belluno;2240;313;154;2707
IT;3;ITH34;Treviso;6459;1256;464;8179
IT;3;ITH35;Venezia;5657;1551;502;7710
IT;3;ITH36;Padova;6445;1581;537;8563
IT;3;ITH37;Rovigo;1758;329;116;2203
IT;2;ITH4;Friuli-Venezia Giulia;9560;1781;809;12150
IT;3;ITH41;Pordenone;2548;387;197;3132
IT;3;ITH42;Udine;4330;764;344;5438
IT;3;ITH43;Gorizia;970;198;78;1246
IT;3;ITH44;Trieste;1711;432;189;2332
IT;2;ITH5;Emilia-Romagna;30760;7433;2634;40827
IT;3;ITH51;Piacenza;2243;475;167;2885
IT;3;ITH52;Parma;3444;689;292;4425
IT;3;ITH53;Reggio nell'Emilia;3561;800;277;4638
IT;3;ITH54;Modena;4750;1113;371;6234
IT;3;ITH55;Bologna;6835;2017;739;9591
IT;3;ITH56;Ferrara;2584;473;178;3235
IT;3;ITH57;Ravenna;2688;647;214;3549
IT;3;ITH58;Forlì-Cesena;2545;646;206;3397
IT;3;ITH59;Rimini;2111;573;191;2875
IT;1;ITI;CENTRO (IT);69973;18679;7215;95867
IT;2;ITI1;Toscana;24024;5828;2104;31956
IT;3;ITI11;Massa-Carrara;1457;262;107;1826
IT;3;ITI12;Lucca;2638;573;201;3412
IT;3;ITI13;Pistoia;1955;388;137;2480
IT;3;ITI14;Firenze;6329;1901;689;8919
IT;3;ITI15;Prato;1492;386;121;1999
IT;3;ITI16;Livorno;2060;508;182;2750
IT;3;ITI17;Pisa;2552;621;237;3410
IT;3;ITI18;Arezzo;2462;460;171;3093
IT;3;ITI19;Siena;1739;439;153;2331
IT;3;ITI1A;Grosseto;1338;290;105;1733
IT;2;ITI2;Umbria;5860;1139;458;7457
IT;3;ITI21;Perugia;4329;862;348;5539
IT;3;ITI22;Terni;1531;277;110;1918
IT;2;ITI3;Marche;10541;2035;806;13382
IT;3;ITI31;Pesaro e Urbino;2509;477;186;3172
IT;3;ITI32;Ancona;3172;683;281;4136
IT;3;ITI33;Macerata;2157;403;155;2715
IT;3;ITI34;Ascoli Piceno;1609;272;116;1997
IT;3;ITI35;Fermo;1093;199;69;1361
IT;2;ITI4;Lazio;29547;9677;3848;43072
IT;3;ITI41;Viterbo;2008;354;149;2511
IT;3;ITI42;Rieti;1148;164;84;1396
IT;3;ITI43;Roma;20789;8007;3215;32011
IT;3;ITI44;Latina;2616;600;197;3413
IT;3;ITI45;Frosinone;2986;552;203;3741
IT;1;ITZ;EXTRA-REGIO NUTS 1;;;;0
IT;2;ITZZ;Extra-Regio NUTS 2;;;;0
IT;3;ITZZZ;Extra-Regio NUTS 3;;;;0
CY;0;CY;?????? (KYPROS);2111;906;130;3147
CY;1;CY0;?????? (Kypros);2111;906;130;3147
CY;2;CY00;?????? (Kypros);2111;906;130;3147
CY;3;CY000;?????? (Kypros);2111;906;130;3147
CY;1;CYZ;EXTRA-REGIO NUTS 1;;;;0
CY;2;CYZZ;Extra-Regio NUTS 2;;;;0
CY;3;CYZZZ;Extra-Regio NUTS 3;;;;0
LV;0;LV;LATVIJA;13623;2981;1628;18232
LV;1;LV0;LATVIJA;13623;2978;1622;18223
LV;2;LV00;Latvija;13623;2978;1622;18223
LV;3;LV003;Kurzeme;1813;297;160;2270
LV;3;LV005;Latgale;2237;260;180;2677
LV;3;LV006;R?ga;3299;1617;813;5729
LV;3;LV007;Pier?ga;2829;427;210;3466
LV;3;LV008;Vidzeme;1676;169;120;1965
LV;3;LV009;Zemgale;1770;208;140;2118
LV;1;LVZ;EXTRA-REGIO NUTS 1;;;;0
LV;2;LVZZ;Extra-Regio NUTS 2;;;;0
LV;3;LVZZZ;Extra-Regio NUTS 3;;;;0
LT;0;LT;LIETUVA;13623;2151;1521;17295
LT;1;LT0;LIETUVA;13623;2151;1521;17295
LT;2;LT00;Lietuva;13623;2151;1521;17295
LT;3;LT001;Alytaus apskritis;748;73;58;879
LT;3;LT002;Kauno apskritis;2683;406;277;3366
LT;3;LT003;Klaip?dos apskritis;1398;267;152;1817
LT;3;LT004;Marijampol?s apskritis;767;72;50;889
LT;3;LT005;Panev?žio apskritis;1233;126;88;1447
LT;3;LT006;Šiauli? apskritis;1427;164;111;1702
LT;3;LT007;Taurag?s apskritis;542;49;35;626
LT;3;LT008;Telši? apskritis;706;74;50;830
LT;3;LT009;Utenos apskritis;784;67;53;904
LT;3;LT00A;Vilniaus apskritis;3335;852;648;4835
LT;1;LTZ;EXTRA-REGIO NUTS 1;;;;0
LT;2;LTZZ;Extra-Regio NUTS 2;;;;0
LT;3;LTZZZ;Extra-Regio NUTS 3;;;;0
LU;0;LU;LUXEMBOURG;4794;2142;1337;8273
LU;1;LU0;LUXEMBOURG;4794;2142;1337;8273
LU;2;LU00;Luxembourg;4794;2142;1337;8273
LU;3;LU000;Luxembourg;4794;2142;1337;8273
LU;1;LUZ;EXTRA-REGIO NUTS 1;;;;0
LU;2;LUZZ;Extra-Regio NUTS 2;;;;0
LU;3;LUZZZ;Extra-Regio NUTS 3;;;;0
HU;0;HU;MAGYARORSZÁG;51799;13027;7155;71981
HU;1;HU1;KÖZÉP-MAGYARORSZÁG;14641;7080;3577;25298
HU;2;HU10;Közép-Magyarország;14641;7080;3577;25298
HU;3;HU101;Budapest;8291;5558;2962;16811
HU;3;HU102;Pest;6350;1521;616;8487
HU;1;HU2;DUNÁNTÚL;15685;2769;1616;20070
HU;2;HU21;Közép-Dunántúl;5477;960;561;6998
HU;3;HU211;Fejér;2073;370;218;2661
HU;3;HU212;Komárom-Esztergom;1512;275;153;1940
HU;3;HU213;Veszprém;1892;315;190;2397
HU;2;HU22;Nyugat-Dunántúl;5237;998;559;6794
HU;3;HU221;Gy?r-Moson-Sopron;2320;485;262;3067
HU;3;HU222;Vas;1403;243;146;1792
HU;3;HU223;Zala;1514;270;151;1935
HU;2;HU23;Dél-Dunántúl;4971;811;496;6278
HU;3;HU231;Baranya;1952;331;218;2501
HU;3;HU232;Somogy;1715;298;163;2176
HU;3;HU233;Tolna;1304;183;115;1602
HU;1;HU3;ALFÖLD ÉS ÉSZAK;21473;3179;1962;26614
HU;2;HU31;Észak-Magyarország;6437;889;578;7904
HU;3;HU311;Borsod-Abaúj-Zemplén;3533;508;336;4377
HU;3;HU312;Heves;1758;251;150;2159
HU;3;HU313;Nógrád;1146;130;93;1369
HU;2;HU32;Észak-Alföld;7709;1182;727;9618
HU;3;HU321;Hajdú-Bihar;2698;501;294;3493
HU;3;HU322;Jász-Nagykun-Szolnok;2061;273;174;2508
HU;3;HU323;Szabolcs-Szatmár-Bereg;2950;408;259;3617
HU;2;HU33;Dél-Alföld;7327;1108;657;9092
HU;3;HU331;Bács-Kiskun;2953;456;247;3656
HU;3;HU332;Békés;2132;263;169;2564
HU;3;HU333;Csongrád;2241;389;241;2871
HU;1;HUZ;EXTRA-REGIO NUTS 1;;;;0
HU;2;HUZZ;Extra-Regio NUTS 2;;;;0
HU;3;HUZZZ;Extra-Regio NUTS 3;;;;0
MT;0;MT;MALTA;526;181;27;734
MT;1;MT0;MALTA;526;181;26;733
MT;2;MT00;Malta;526;181;26;733
MT;3;MT001;Malta;478;170;25;673
MT;3;MT002;Gozo and Comino / G?awdex u Kemmuna;49;11;1;61
MT;1;MTZ;EXTRA-REGIO NUTS 1;;;;0
MT;2;MTZZ;Extra-Regio NUTS 2;;;;0
MT;3;MTZZZ;Extra-Regio NUTS 3;;;;0
NL;0;NL;NEDERLAND ;96966;36170;28315;161451
NL;1;NL1;NOORD-NEDERLAND;10687;2548;2438;15673
NL;2;NL11;Groningen;3644;898;904;5446
NL;3;NL111;Oost-Groningen;966;170;158;1294
NL;3;NL112;Delfzijl en omgeving;322;84;52;458
NL;3;NL113;Overig Groningen;2356;644;694;3694
NL;2;NL12;Friesland (NL);3987;969;873;5829
NL;3;NL121;Noord-Friesland;2046;516;464;3026
NL;3;NL122;Zuidwest-Friesland;662;138;117;917
NL;3;NL123;Zuidoost-Friesland;1278;314;292;1884
NL;2;NL13;Drenthe;3056;681;661;4398
NL;3;NL131;Noord-Drenthe;1194;272;283;1749
NL;3;NL132;Zuidoost-Drenthe;1047;209;185;1441
NL;3;NL133;Zuidwest-Drenthe;815;200;192;1207
NL;1;NL2;OOST-NEDERLAND;20137;6201;5405;31743
NL;2;NL21;Overijssel;6630;1917;1678;10225
NL;3;NL211;Noord-Overijssel;2046;683;580;3309
NL;3;NL212;Zuidwest-Overijssel;887;236;224;1347
NL;3;NL213;Twente;3697;998;874;5569
NL;2;NL22;Gelderland;11581;3637;3123;18341
NL;3;NL221;Veluwe;3682;1328;1112;6122
NL;3;NL224;Zuidwest-Gelderland;1284;453;312;2049
NL;3;NL225;Achterhoek;2452;610;474;3536
NL;3;NL226;Arnhem/Nijmegen;4163;1246;1225;6634
NL;2;NL23;Flevoland;1926;647;603;3176
NL;3;NL230;Flevoland;1926;647;603;3176
NL;1;NL3;WEST-NEDERLAND;44520;19932;14889;79341
NL;2;NL31;Utrecht;6834;3389;2645;12868
NL;3;NL310;Utrecht;6834;3389;2645;12868
NL;2;NL32;Noord-Holland;15538;8384;5469;29391
NL;3;NL321;Kop van Noord-Holland;2166;536;454;3156
NL;3;NL322;Alkmaar en omgeving;1317;434;348;2099
NL;3;NL323;IJmond;1094;293;216;1603
NL;3;NL324;Agglomeratie Haarlem;1357;411;368;2136
NL;3;NL325;Zaanstreek;911;257;194;1362
NL;3;NL326;Groot-Amsterdam;7191;5777;3477;16445
NL;3;NL327;Het Gooi en Vechtstreek;1501;677;413;2591
NL;2;NL33;Zuid-Holland;19897;7591;6324;33812
NL;3;NL332;Agglomeratie 's-Gravenhage;4737;1842;1901;8480
NL;3;NL333;Delft en Westland;1169;433;377;1979
NL;3;NL337;Agglomeratie Leiden en Bollenstreek;2252;738;659;3649
NL;3;NL338;Oost-Zuid-Holland;1601;547;410;2558
NL;3;NL339;Groot-Rijnmond;7963;3248;2438;13649
NL;3;NL33A;Zuidoost-Zuid-Holland;2174;783;539;3496
NL;2;NL34;Zeeland;2252;567;450;3269
NL;3;NL341;Zeeuwsch-Vlaanderen;665;170;116;951
NL;3;NL342;Overig Zeeland;1587;397;335;2319
NL;1;NL4;ZUID-NEDERLAND;21622;6803;5465;33890
NL;2;NL41;Noord-Brabant;14404;4904;3858;23166
NL;3;NL411;West-Noord-Brabant;3557;1257;983;5797
NL;3;NL412;Midden-Noord-Brabant;2652;884;661;4197
NL;3;NL413;Noordoost-Noord-Brabant;3741;1261;971;5973
NL;3;NL414;Zuidoost-Noord-Brabant;4453;1502;1243;7198
NL;2;NL42;Limburg (NL);7218;1900;1607;10725
NL;3;NL421;Noord-Limburg;1689;492;359;2540
NL;3;NL422;Midden-Limburg;1490;371;295;2156
NL;3;NL423;Zuid-Limburg;4039;1037;954;6030
NL;1;NLZ;EXTRA-REGIO NUTS 1;;;;0
NL;2;NLZZ;Extra-Regio NUTS 2;;;;0
NL;3;NLZZZ;Extra-Regio NUTS 3;;;;0
AT;0;AT;ÖSTERREICH;63199;12791;6379;82369
AT;1;AT1;OSTÖSTERREICH;26358;6044;3029;35431
AT;2;AT11;Burgenland ;2271;292;143;2706
AT;3;AT111;Mittelburgenland;324;31;15;370
AT;3;AT112;Nordburgenland;1167;167;81;1415
AT;3;AT113;Südburgenland;780;94;46;920
AT;2;AT12;Niederösterreich;12970;1993;947;15910
AT;3;AT121;Mostviertel-Eisenwurzen;1846;244;117;2207
AT;3;AT122;Niederösterreich-Süd;2145;286;141;2572
AT;3;AT123;Sankt Pölten;1137;236;113;1486
AT;3;AT124;Waldviertel;1958;246;120;2324
AT;3;AT125;Weinviertel;1096;111;53;1260
AT;3;AT126;Wiener Umland/Nordteil;2437;315;147;2899
AT;3;AT127;Wiener Umland/Südteil;2351;554;256;3161
AT;2;AT13;Wien;11117;3759;1939;16815
AT;3;AT130;Wien;11117;3759;1939;16815
AT;1;AT2;SÜDÖSTERREICH;13859;2169;1199;17227
AT;2;AT21;Kärnten;4441;677;367;5485
AT;3;AT211;Klagenfurt-Villach;2163;400;217;2780
AT;3;AT212;Oberkärnten;1137;141;78;1356
AT;3;AT213;Unterkärnten;1140;136;72;1348
AT;2;AT22;Steiermark;9418;1491;832;11741
AT;3;AT221;Graz;2949;672;374;3995
AT;3;AT222;Liezen;698;102;59;859
AT;3;AT223;Östliche Obersteiermark;1473;187;108;1768
AT;3;AT224;Oststeiermark;1964;254;138;2356
AT;3;AT225;West- und Südsteiermark;1420;166;89;1675
AT;3;AT226;Westliche Obersteiermark;913;110;64;1087
AT;1;AT3;WESTÖSTERREICH;22982;4575;2149;29706
AT;2;AT31;Oberösterreich;10914;1811;947;13672
AT;3;AT311;Innviertel;2235;275;144;2654
AT;3;AT312;Linz-Wels;3985;940;489;5414
AT;3;AT313;Mühlviertel;1601;180;94;1875
AT;3;AT314;Steyr-Kirchdorf;1209;167;88;1464
AT;3;AT315;Traunviertel;1884;249;132;2265
AT;2;AT32;Salzburg;3890;1050;441;5381
AT;3;AT321;Lungau;176;31;14;221
AT;3;AT322;Pinzgau-Pongau;1252;280;121;1653
AT;3;AT323;Salzburg und Umgebung;2462;738;306;3506
AT;2;AT33;Tirol;5426;1181;522;7129
AT;3;AT331;Außerfern;259;50;22;331
AT;3;AT332;Innsbruck;2193;535;236;2964
AT;3;AT333;Osttirol;406;60;27;493
AT;3;AT334;Tiroler Oberland;789;184;82;1055
AT;3;AT335;Tiroler Unterland;1780;351;155;2286
AT;2;AT34;Vorarlberg;2751;533;239;3523
AT;3;AT341;Bludenz-Bregenzer Wald;731;149;67;947
AT;3;AT342;Rheintal-Bodenseegebiet;2020;385;172;2577
AT;1;ATZ;EXTRA-REGIO NUTS 1;;;;0
AT;2;ATZZ;Extra-Regio NUTS 2;;;;0
AT;3;ATZZZ;Extra-Regio NUTS 3;;;;0
PL;0;PL;POLSKA;198936;37481;21518;257935
PL;1;PL1;REGION CENTRALNY;41185;9591;5488;56264
PL;2;PL11;?ódzkie;13718;2284;1307;17309
PL;3;PL113;Miasto ?ód?;3291;870;495;4656
PL;3;PL114;?ódzki;2288;319;183;2790
PL;3;PL115;Piotrkowski;3392;466;269;4127
PL;3;PL116;Sieradzki;2716;341;195;3252
PL;3;PL117;Skierniewicki;2031;288;165;2484
PL;2;PL12;Mazowieckie;27467;7307;4181;38955
PL;3;PL127;Miasto Warszawa;7545;4041;2305;13891
PL;3;PL128;Radomski;3278;491;282;4051
PL;3;PL129;Warszawski wschodni;4696;658;377;5731
PL;3;PL12A;Warszawski zachodni;4844;821;474;6139
PL;3;PL12B;Ciechanowski;1774;323;186;2283
PL;3;PL12C;P?ocki;1688;309;177;2174
PL;3;PL12D;Ostro??cki;2006;366;210;2582
PL;3;PL12E;Siedlecki;1635;298;171;2104
PL;1;PL2;REGION PO?UDNIOWY;41338;7565;4374;53277
PL;2;PL21;Ma?opolskie;17480;3225;1871;22576
PL;3;PL213;Miasto Kraków;3090;1016;589;4695
PL;3;PL214;Krakowski;4488;525;304;5317
PL;3;PL217;Tarnowski;2473;352;202;3027
PL;3;PL218;Nowos?decki;2781;499;291;3571
PL;3;PL219;Nowotarski;1814;322;189;2325
PL;3;PL21A;O?wi?cimski;2833;512;296;3641
PL;2;PL22;?l?skie;23858;4340;2504;30702
PL;3;PL224;Cz?stochowski;3033;439;254;3726
PL;3;PL225;Bielski;4412;629;372;5413
PL;3;PL227;Rybnicki;3306;504;289;4099
PL;3;PL228;Bytomski;2239;390;224;2853
PL;3;PL229;Gliwicki;2144;484;275;2903
PL;3;PL22A;Katowicki;3218;930;532;4680
PL;3;PL22B;Sosnowiecki;3563;626;363;4552
PL;3;PL22C;Tyski;1943;339;196;2478
PL;1;PL3;REGION WSCHODNI;37194;5422;3127;45743
PL;2;PL31;Lubelskie;12271;1770;1015;15056
PL;3;PL311;Bialski;1887;245;140;2272
PL;3;PL312;Che?msko-zamojski;3976;488;280;4744
PL;3;PL314;Lubelski;3547;669;383;4599
PL;3;PL315;Pu?awski;2862;369;211;3442
PL;2;PL32;Podkarpackie;11279;1650;951;13880
PL;3;PL323;Kro?nie?ski;2778;368;216;3362
PL;3;PL324;Przemyski;2140;299;171;2610
PL;3;PL325;Rzeszowski;3326;539;310;4175
PL;3;PL326;Tarnobrzeski;3035;444;255;3734
PL;2;PL33;?wi?tokrzyskie;7055;1014;588;8657
PL;3;PL331;Kielecki;4030;662;385;5077
PL;3;PL332;Sandomiersko-j?drzejowski;3024;352;203;3579
PL;2;PL34;Podlaskie;6589;989;573;8151
PL;3;PL343;Bia?ostocki;2574;471;273;3318
PL;3;PL344;?om?y?ski;2515;309;178;3002
PL;3;PL345;Suwalski;1500;209;122;1831
PL;1;PL4;REGION PÓ?NOCNO-ZACHODNI;31158;5872;3345;40375
PL;2;PL41;Wielkopolskie;17995;3296;1873;23164
PL;3;PL411;Pilski;2089;334;191;2614
PL;3;PL414;Koni?ski;3470;516;295;4281
PL;3;PL415;Miasto Pozna?;2450;872;495;3817
PL;3;PL416;Kaliski;3723;544;310;4577
PL;3;PL417;Leszczy?ski;2991;465;263;3719
PL;3;PL418;Pozna?ski;3271;563;320;4154
PL;2;PL42;Zachodniopomorskie;8074;1696;976;10746
PL;3;PL424;Miasto Szczecin;1734;480;275;2489
PL;3;PL426;Koszali?ski;1743;332;193;2268
PL;3;PL427;Szczecinecko-pyrzycki;2133;410;236;2779
PL;3;PL428;Szczeci?ski;2464;474;272;3210
PL;2;PL43;Lubuskie;5089;880;496;6465
PL;3;PL431;Gorzowski;1857;333;188;2378
PL;3;PL432;Zielonogórski;3232;547;308;4087
PL;1;PL5;REGION PO?UDNIOWO-ZACHODNI;20511;3784;2144;26439
PL;2;PL51;Dolno?l?skie;14751;2910;1650;19311
PL;3;PL514;Miasto Wroc?aw;2751;883;500;4134
PL;3;PL515;Jeleniogórski;3165;522;296;3983
PL;3;PL516;Legnicko-g?ogowski;2071;407;231;2709
PL;3;PL517;Wa?brzyski;3563;621;353;4537
PL;3;PL518;Wroc?awski;3201;476;268;3945
PL;2;PL52;Opolskie;5760;874;495;7129
PL;3;PL523;Nyski;2225;311;176;2712
PL;3;PL524;Opolski;3535;564;319;4418
PL;1;PL6;REGION PÓ?NOCNY;27550;5246;3039;35835
PL;2;PL61;Kujawsko-pomorskie;9916;1881;1079;12876
PL;3;PL613;Bydgosko-toru?ski;3396;774;445;4615
PL;3;PL616;Grudzi?dzki;1950;303;174;2427
PL;3;PL617;Inowroc?awski;1815;283;162;2260
PL;3;PL618;?wiecki;950;178;103;1231
PL;3;PL619;W?oc?awski;1805;343;195;2343
PL;2;PL62;Warmi?sko-mazurskie;6812;1216;703;8731
PL;3;PL621;Elbl?ski;2540;428;247;3215
PL;3;PL622;Olszty?ski;2941;560;325;3826
PL;3;PL623;E?cki;1330;228;132;1690
PL;2;PL63;Pomorskie;10823;2149;1257;14229
PL;3;PL633;Trójmiejski;3176;913;535;4624
PL;3;PL634;Gda?ski;2937;412;244;3593
PL;3;PL636;S?upski;1606;270;157;2033
PL;3;PL637;Chojnicki;1079;210;122;1411
PL;3;PL638;Starogardzki;2024;345;198;2567
PL;1;PLZ;EXTRA-REGIO NUTS 1;;;;0
PL;2;PLZZ;Extra-Regio NUTS 2;;;;0
PL;3;PLZZZ;Extra-Regio NUTS 3;;;;0
PT;0;PT;PORTUGAL;12249;6768;1963;20980
PT;1;PT1;CONTINENTE;11898;6444;1896;20238
PT;2;PT11;Norte;4557;1652;594;6803
PT;3;PT111;Alto Minho;325;87;37;449
PT;3;PT112;Cávado;492;164;58;714
PT;3;PT119;Ave;508;193;62;763
PT;3;PT11A;Área Metropolitana do Porto;2121;786;278;3185
PT;3;PT11B;Alto Tâmega;139;132;50;321
PT;3;PT11C;Tâmega e Sousa;502;125;41;668
PT;3;PT11D;Douro;284;86;33;403
PT;3;PT11E;Terras de Trás-os-Montes;187;79;34;300
PT;2;PT15;Algarve;517;381;73;971
PT;3;PT150;Algarve;517;381;73;971
PT;2;PT16;Centro (PT);2895;1306;382;4583
PT;3;PT16B;Oeste;402;219;44;665
PT;3;PT16D;Região de Aveiro;459;202;65;726
PT;3;PT16E;Região de Coimbra;600;259;84;943
PT;3;PT16F;Região de Leiria;350;175;50;575
PT;3;PT16G;Viseu Dão Lafões;336;151;49;536
PT;3;PT16H;Beira Baixa;116;60;16;192
PT;3;PT16I;Médio Tejo;297;139;38;474
PT;3;PT16J;Beiras e Serra da Estrela;335;101;37;473
PT;2;PT17;Área Metropolitana de Lisboa;3058;2645;729;6432
PT;3;PT170;Área Metropolitana de Lisboa;3058;2645;729;6432
PT;2;PT18;Alentejo;871;460;118;1449
PT;3;PT181;Alentejo Litoral;111;74;15;200
PT;3;PT184;Baixo Alentejo;147;67;20;234
PT;3;PT185;Lezíria do Tejo;273;156;34;463
PT;3;PT186;Alto Alentejo;143;64;19;226
PT;3;PT187;Alentejo Central;197;100;30;327
PT;1;PT2;REGIÃO AUTÓNOMA DOS AÇORES;205;118;37;360
PT;2;PT20;Região Autónoma dos Açores;205;118;37;360
PT;3;PT200;Região Autónoma dos Açores;205;118;37;360
PT;1;PT3;REGIÃO AUTÓNOMA DA MADEIRA;146;201;26;373
PT;2;PT30;Região Autónoma da Madeira;146;201;26;373
PT;3;PT300;Região Autónoma da Madeira;146;201;26;373
PT;1;PTZ;EXTRA-REGIO NUTS 1;;;;0
PT;2;PTZZ;Extra-Regio NUTS 2;;;;0
PT;3;PTZZZ;Extra-Regio NUTS 3;;;;0
RO;0;RO;ROMÂNIA;61800;8245;4225;74270
RO;1;RO1;MACROREGIUNEA UNU;16124;1884;963;18971
RO;2;RO11;Nord-Vest;8245;974;491;9710
RO;3;RO111;Bihor;1732;190;96;2018
RO;3;RO112;Bistri?a-N?s?ud;879;79;49;1007
RO;3;RO113;Cluj;2213;387;181;2781
RO;3;RO114;Maramure?;1635;169;80;1884
RO;3;RO115;Satu Mare;1095;84;50;1229
RO;3;RO116;S?laj;691;64;35;790
RO;2;RO12;Centru;7878;910;472;9260
RO;3;RO121;Alba;1166;127;69;1362
RO;3;RO122;Bra?ov;1890;303;126;2319
RO;3;RO123;Covasna;689;58;36;783
RO;3;RO124;Harghita;1099;101;57;1257
RO;3;RO125;Mure?;1725;163;95;1983
RO;3;RO126;Sibiu;1309;157;90;1556
RO;1;RO2;MACROREGIUNEA DOI;17728;1745;946;20419
RO;2;RO21;Nord-Est;10190;962;540;11692
RO;3;RO211;Bac?u;1883;187;95;2165
RO;3;RO212;Boto?ani;1256;98;58;1412
RO;3;RO213;Ia?i;2226;271;161;2658
RO;3;RO214;Neam?;1560;131;71;1762
RO;3;RO215;Suceava;2112;186;101;2399
RO;3;RO216;Vaslui;1153;89;54;1296
RO;2;RO22;Sud-Est;7537;783;406;8726
RO;3;RO221;Br?ila;837;75;46;958
RO;3;RO222;Buz?u;1405;111;61;1577
RO;3;RO223;Constan?a;1958;305;131;2394
RO;3;RO224;Gala?i;1596;141;86;1823
RO;3;RO225;Tulcea;664;63;35;762
RO;3;RO226;Vrancea;1076;87;46;1209
RO;1;RO3;MACROREGIUNEA TREI;15827;3283;1643;20753
RO;2;RO31;Sud - Muntenia;9046;845;462;10353
RO;3;RO311;Arge?;1912;191;103;2206
RO;3;RO312;C?l?ra?i;778;67;37;882
RO;3;RO313;Dâmbovi?a;1459;140;70;1669
RO;3;RO314;Giurgiu;797;93;35;925
RO;3;RO315;Ialomi?a;744;74;36;854
RO;3;RO316;Prahova;2262;202;130;2594
RO;3;RO317;Teleorman;1093;77;49;1219
RO;2;RO32;Bucure?ti - Ilfov;6781;2438;1181;10400
RO;3;RO321;Bucure?ti;5603;2164;1081;8848
RO;3;RO322;Ilfov;1178;275;100;1553
RO;1;RO4;MACROREGIUNEA PATRU;12122;1328;664;14114
RO;2;RO41;Sud-Vest Oltenia;6190;561;318;7069
RO;3;RO411;Dolj;1991;182;109;2282
RO;3;RO412;Gorj;993;110;56;1159
RO;3;RO413;Mehedin?i;778;64;38;880
RO;3;RO414;Olt;1278;83;55;1416
RO;3;RO415;Vâlcea;1150;123;61;1334
RO;2;RO42;Vest;5932;767;346;7045
RO;3;RO421;Arad;1413;156;75;1644
RO;3;RO422;Cara?-Severin;1036;114;51;1201
RO;3;RO423;Hunedoara;1214;141;65;1420
RO;3;RO424;Timi?;2269;356;155;2780
RO;1;ROZ;EXTRA-REGIO NUTS 1;;;;0
RO;2;ROZZ;Extra-Regio NUTS 2;;;;0
RO;3;ROZZZ;Extra-Regio NUTS 3;;;;0
SI;0;SI;SLOVENIJA;11523;1682;781;13986
SI;1;SI0;SLOVENIJA;11523;1682;781;13986
SI;2;SI03;Vzhodna Slovenija;6158;678;314;7150
SI;3;SI031;Pomurska;695;69;30;794
SI;3;SI032;Podravska;1780;227;107;2114
SI;3;SI033;Koroška;425;38;20;483
SI;3;SI034;Savinjska;1416;163;72;1651
SI;3;SI035;Zasavska;291;28;14;333
SI;3;SI036;Posavska;423;44;19;486
SI;3;SI037;Jugovzhodna Slovenija;793;81;39;913
SI;3;SI038;Primorsko-notranjska;335;29;13;377
SI;2;SI04;Zahodna Slovenija;5365;1004;467;6836
SI;3;SI041;Osrednjeslovenska;2789;672;322;3783
SI;3;SI042;Gorenjska;1247;132;63;1442
SI;3;SI043;Goriška;760;75;44;879
SI;3;SI044;Obalno-kraška;569;125;38;732
SI;1;SIZ;EXTRA-REGIO NUTS 1;;;;0
SI;2;SIZZ;Extra-Regio NUTS 2;;;;0
SI;3;SIZZZ;Extra-Regio NUTS 3;;;;0
SK;0;SK;SLOVENSKO;20212;12592;6992;39796
SK;1;SK0;SLOVENSKO;20212;12592;6992;39796
SK;2;SK01;Bratislavský kraj;2346;3768;1864;7978
SK;3;SK010;Bratislavský kraj;2346;3768;1864;7978
SK;2;SK02;Západné Slovensko;7045;3544;2022;12611
SK;3;SK021;Trnavský kraj;2029;1188;647;3864
SK;3;SK022;Tren?iansky kraj;2355;1087;744;4186
SK;3;SK023;Nitriansky kraj;2661;1269;631;4561
SK;2;SK03;Stredné Slovensko;5382;2557;1528;9467
SK;3;SK031;Žilinský kraj;2755;1405;842;5002
SK;3;SK032;Banskobystrický kraj;2627;1152;686;4465
SK;2;SK04;Východné Slovensko;5440;2723;1578;9741
SK;3;SK041;Prešovský kraj;2742;1205;743;4690
SK;3;SK042;Košický kraj;2698;1518;834;5050
SK;1;SKZ;EXTRA-REGIO NUTS 1;;;;0
SK;2;SKZZ;Extra-Regio NUTS 2;;;;0
SK;3;SKZZZ;Extra-Regio NUTS 3;;;;0
FI;0;FI;SUOMI / FINLAND;58513;10634;9001;78148
FI;1;FI1;MANNER-SUOMI;58210;10555;8942;77707
FI;2;FI19;Länsi-Suomi;14918;2150;1977;19045
FI;3;FI193;Keski-Suomi;3036;419;388;3843
FI;3;FI194;Etelä-Pohjanmaa;2139;278;254;2671
FI;3;FI195;Pohjanmaa;1961;269;260;2490
FI;3;FI196;Satakunta;2595;332;313;3240
FI;3;FI197;Pirkanmaa;5186;852;763;6801
FI;2;FI1B;Helsinki-Uusimaa;14957;4466;3227;22650
FI;3;FI1B1;Helsinki-Uusimaa;14957;4466;3227;22650
FI;2;FI1C;Etelä-Suomi;12943;1912;1717;16572
FI;3;FI1C1;Varsinais-Suomi;5033;777;707;6517
FI;3;FI1C2;Kanta-Häme;1945;274;263;2482
FI;3;FI1C3;Päijät-Häme;2287;326;281;2894
FI;3;FI1C4;Kymenlaakso;2132;317;270;2719
FI;3;FI1C5;Etelä-Karjala;1546;218;196;1960
FI;2;FI1D;Pohjois- ja Itä-Suomi;15393;2028;2021;19442
FI;3;FI1D1;Etelä-Savo;1934;227;219;2380
FI;3;FI1D2;Pohjois-Savo;2891;391;387;3669
FI;3;FI1D3;Pohjois-Karjala;2057;249;238;2544
FI;3;FI1D4;Kainuu;1064;121;131;1316
FI;3;FI1D5;Keski-Pohjanmaa;739;115;99;953
FI;3;FI1D6;Pohjois-Pohjanmaa;4304;617;626;5547
FI;3;FI1D7;Lappi;2404;308;321;3033
FI;1;FI2;ÅLAND;303;75;51;429
FI;2;FI20;Åland;303;75;51;429
FI;3;FI200;Åland;303;75;51;429
FI;1;FIZ;EXTRA-REGIO NUTS 1;;;;0
FI;2;FIZZ;Extra-Regio NUTS 2;;;;0
FI;3;FIZZZ;Extra-Regio NUTS 3;;;;0
SE;0;SE;SVERIGE;70410;15538;13483;99431
SE;1;SE1;ÖSTRA SVERIGE;24831;7630;5922;38383
SE;2;SE11;Stockholm;13114;5683;3834;22631
SE;3;SE110;Stockholms län;13114;5683;3834;22631
SE;2;SE12;Östra Mellansverige;11718;1947;2089;15754
SE;3;SE121;Uppsala län;2347;416;535;3298
SE;3;SE122;Södermanlands län;2024;314;312;2650
SE;3;SE123;Östergötlands län;3176;562;557;4295
SE;3;SE124;Örebro län;2228;349;374;2951
SE;3;SE125;Västmanlands län;1943;307;311;2561
SE;1;SE2;SÖDRA SVERIGE;30147;5612;5112;40871
SE;2;SE21;Småland med öarna;6494;976;968;8438
SE;3;SE211;Jönköpings län;2655;410;411;3476
SE;3;SE212;Kronobergs län;1490;240;224;1954
SE;3;SE213;Kalmar län;1902;256;257;2415
SE;3;SE214;Gotlands län;446;71;75;592
SE;2;SE22;Sydsverige;9924;1863;1708;13495
SE;3;SE221;Blekinge län;1199;171;186;1556
SE;3;SE224;Skåne län;8725;1692;1522;11939
SE;2;SE23;Västsverige;13729;2773;2435;18937
SE;3;SE231;Hallands län;2318;370;344;3032
SE;3;SE232;Västra Götalands län;11411;2404;2092;15907
SE;1;SE3;NORRA SVERIGE;15432;2292;2440;20164
SE;2;SE31;Norra Mellansverige;7336;1007;1075;9418
SE;3;SE311;Värmlands län;2381;320;338;3039
SE;3;SE312;Dalarnas län;2532;364;371;3267
SE;3;SE313;Gävleborgs län;2422;322;366;3110
SE;2;SE32;Mellersta Norrland;3407;557;547;4511
SE;3;SE321;Västernorrlands län;2222;389;356;2967
SE;3;SE322;Jämtlands län;1185;169;192;1546
SE;2;SE33;Övre Norrland;4689;728;818;6235
SE;3;SE331;Västerbottens län;2382;368;411;3161
SE;3;SE332;Norrbottens län;2307;360;407;3074
SE;1;SEZ;EXTRA-REGIO NUTS 1;;3;8;11
SE;2;SEZZ;Extra-Regio NUTS 2;;3;8;11
SE;3;SEZZZ;Extra-Regio NUTS 3;;3;8;11
UK;0;UK;UNITED KINGDOM;360297;69558;38078;467933
UK;1;UKC;NORTH EAST (ENGLAND);16303;2616;1612;20531
UK;2;UKC1;Tees Valley and Durham;7350;1052;661;9063
UK;3;UKC11;Hartlepool and Stockton-on-Tees;1723;265;162;2150
UK;3;UKC12;South Teesside;1735;263;163;2161
UK;3;UKC13;Darlington;668;138;74;880
UK;3;UKC14;Durham CC;3224;387;261;3872
UK;2;UKC2;Northumberland and Tyne and Wear;8953;1564;951;11468
UK;3;UKC21;Northumberland;2156;257;157;2570
UK;3;UKC22;Tyneside;5091;1031;641;6763
UK;3;UKC23;Sunderland;1706;276;154;2136
UK;1;UKD;NORTH WEST (ENGLAND);41638;7002;3951;52591
UK;2;UKD1;Cumbria;3206;487;277;3970
UK;3;UKD11;West Cumbria;1471;171;116;1758
UK;3;UKD12;East Cumbria;1735;316;161;2212
UK;2;UKD3;Greater Manchester;15374;2382;1302;19058
UK;3;UKD33;Manchester;2895;452;247;3594
UK;3;UKD34;Greater Manchester South West;2570;402;219;3191
UK;3;UKD35;Greater Manchester South East;2845;444;243;3532
UK;3;UKD36;Greater Manchester North West;3395;522;285;4202
UK;3;UKD37;Greater Manchester North East;3668;563;308;4539
UK;2;UKD4;Lancashire;8436;1277;730;10443
UK;3;UKD41;Blackburn with Darwen;787;130;82;999
UK;3;UKD42;Blackpool;838;117;84;1039
UK;3;UKD44;Lancaster and Wyre;1406;213;117;1736
UK;3;UKD45;Mid Lancashire;2240;339;185;2764
UK;3;UKD46;East Lancashire;1920;290;159;2369
UK;3;UKD47;Chorley and West Lancashire;1245;189;103;1537
UK;2;UKD6;Cheshire;5626;1289;666;7581
UK;3;UKD61;Warrington;1232;315;179;1726
UK;3;UKD62;Cheshire East;2340;519;268;3127
UK;3;UKD63;Cheshire West and Chester;2053;455;218;2726
UK;2;UKD7;Merseyside;8996;1565;976;11537
UK;3;UKD71;East Merseyside;2659;445;253;3357
UK;3;UKD72;Liverpool;2676;659;411;3746
UK;3;UKD73;Sefton;1696;242;149;2087
UK;3;UKD74;Wirral;1965;219;163;2347
UK;1;UKE;YORKSHIRE AND THE HUMBER;30777;5882;3189;39848
UK;2;UKE1;East Yorkshire and Northern Lincolnshire;5395;804;469;6668
UK;3;UKE11;Kingston upon Hull, City of;1407;231;154;1792
UK;3;UKE12;East Riding of Yorkshire;2060;280;161;2501
UK;3;UKE13;North and North East Lincolnshire;1927;293;154;2374
UK;2;UKE2;North Yorkshire;4925;992;510;6427
UK;3;UKE21;York;1174;324;152;1650
UK;3;UKE22;North Yorkshire CC;3752;668;358;4778
UK;2;UKE3;South Yorkshire;7770;1288;762;9820
UK;3;UKE31;Barnsley, Doncaster and Rotherham;4609;622;378;5609
UK;3;UKE32;Sheffield;3161;666;384;4211
UK;2;UKE4;West Yorkshire;12687;2799;1447;16933
UK;3;UKE41;Bradford;2802;527;301;3630
UK;3;UKE42;Leeds;4322;1225;642;6189
UK;3;UKE44;Calderdale and Kirklees;3632;667;321;4620
UK;3;UKE45;Wakefield;1931;379;184;2494
UK;1;UKF;EAST MIDLANDS (ENGLAND);26212;4791;2646;33649
UK;2;UKF1;Derbyshire and Nottinghamshire;12471;2220;1236;15927
UK;3;UKF11;Derby;1385;325;178;1888
UK;3;UKF12;East Derbyshire;1725;243;134;2102
UK;3;UKF13;South and West Derbyshire;3037;435;242;3714
UK;3;UKF14;Nottingham;1630;525;316;2471
UK;3;UKF15;North Nottinghamshire;2719;398;219;3336
UK;3;UKF16;South Nottinghamshire;1975;292;148;2415
UK;2;UKF2;Leicestershire, Rutland and Northamptonshire;9466;1939;1027;12432
UK;3;UKF21;Leicester;1611;335;233;2179
UK;3;UKF22;Leicestershire CC and Rutland;3976;756;370;5102
UK;3;UKF24;West Northamptonshire;2093;513;260;2866
UK;3;UKF25;North Northamptonshire;1785;335;164;2284
UK;2;UKF3;Lincolnshire;4276;633;383;5292
UK;3;UKF30;Lincolnshire;4276;633;383;5292
UK;1;UKG;WEST MIDLANDS (ENGLAND);31637;6322;3299;41258
UK;2;UKG1;Herefordshire, Worcestershire and Warwickshire;7586;1493;759;9838
UK;3;UKG11;Herefordshire, County of;1103;168;97;1368
UK;3;UKG12;Worcestershire;3300;604;299;4203
UK;3;UKG13;Warwickshire;3183;722;363;4268
UK;2;UKG2;Shropshire and Staffordshire;9377;1612;857;11846
UK;3;UKG21;Telford and Wrekin;938;203;93;1234
UK;3;UKG22;Shropshire CC;1857;300;177;2334
UK;3;UKG23;Stoke-on-Trent;1522;250;161;1933
UK;3;UKG24;Staffordshire CC;5061;860;426;6347
UK;2;UKG3;West Midlands;14674;3216;1683;19573
UK;3;UKG31;Birmingham;5469;1404;773;7646
UK;3;UKG32;Solihull;1180;334;132;1646
UK;3;UKG33;Coventry;1635;380;206;2221
UK;3;UKG36;Dudley;1815;257;146;2218
UK;3;UKG37;Sandwell;1674;310;141;2125
UK;3;UKG38;Walsall;1487;256;127;1870
UK;3;UKG39;Wolverhampton;1414;275;158;1847
UK;1;UKH;EAST OF ENGLAND;31806;6682;3505;41993
UK;2;UKH1;East Anglia;13509;2658;1474;17641
UK;3;UKH11;Peterborough;981;276;139;1396
UK;3;UKH12;Cambridgeshire CC;3352;840;512;4704
UK;3;UKH14;Suffolk;4140;819;426;5385
UK;3;UKH15;Norwich and East Norfolk;2066;297;163;2526
UK;3;UKH16;North and West Norfolk;1464;210;115;1789
UK;3;UKH17;Breckland and South Norfolk;1506;217;119;1842
UK;2;UKH2;Bedfordshire and Hertfordshire;9015;2507;1227;12749
UK;3;UKH21;Luton;978;261;130;1369
UK;3;UKH23;Hertfordshire;5799;1742;849;8390
UK;3;UKH24;Bedford;846;211;111;1168
UK;3;UKH25;Central Bedfordshire;1393;294;138;1825
UK;2;UKH3;Essex;9281;1517;804;11602
UK;3;UKH31;Southend-on-Sea;930;169;101;1200
UK;3;UKH32;Thurrock;780;183;65;1028
UK;3;UKH34;Essex Haven Gateway;2488;382;210;3080
UK;3;UKH35;West Essex;1591;244;134;1969
UK;3;UKH36;Heart of Essex;1631;251;138;2020
UK;3;UKH37;Essex Thames Gateway;1862;286;157;2305
UK;1;UKI;LONDON;41926;7389;4015;53330
UK;2;UKI3;Inner London - West;5872;970;527;7369
UK;3;UKI31;Camden and City of London;1257;208;113;1578
UK;3;UKI32;Westminster;1204;199;108;1511
UK;3;UKI33;Kensington & Chelsea and Hammersmith & Fulham;1765;292;159;2216
UK;3;UKI34;Wandsworth;1647;272;148;2067
UK;2;UKI4;Inner London - East;10524;1953;1061;13538
UK;3;UKI41;Hackney and Newham;2723;505;275;3503
UK;3;UKI42;Tower Hamlets;1289;239;130;1658
UK;3;UKI43;Haringey and Islington;2265;420;228;2913
UK;3;UKI44;Lewisham and Southwark;2764;513;279;3556
UK;3;UKI45;Lambeth;1484;275;150;1909
UK;2;UKI5;Outer London - East and North East;8997;1593;866;11456
UK;3;UKI51;Bexley and Greenwich;2490;441;240;3171
UK;3;UKI52;Barking & Dagenham and Havering;2164;383;208;2755
UK;3;UKI53;Redbridge and Waltham Forest;2751;487;265;3503
UK;3;UKI54;Enfield;1592;282;153;2027
UK;2;UKI6;Outer London - South;6665;1104;600;8369
UK;3;UKI61;Bromley;1690;280;152;2122
UK;3;UKI62;Croydon;1971;327;178;2476
UK;3;UKI63;Merton, Kingston upon Thames and Sutton;3003;498;271;3772
UK;2;UKI7;Outer London - West and North West;9868;1768;960;12596
UK;3;UKI71;Barnet;1813;325;176;2314
UK;3;UKI72;Brent;1556;279;151;1986
UK;3;UKI73;Ealing;1685;302;164;2151
UK;3;UKI74;Harrow and Hillingdon;2611;468;254;3333
UK;3;UKI75;Hounslow and Richmond upon Thames;2203;395;214;2812
UK;1;UKJ;SOUTH EAST (ENGLAND);45833;10584;5245;61662
UK;2;UKJ1;Berkshire, Buckinghamshire and Oxfordshire;11936;4805;2070;18811
UK;3;UKJ11;Berkshire;4402;2231;801;7434
UK;3;UKJ12;Milton Keynes;1319;689;254;2262
UK;3;UKJ13;Buckinghamshire CC;2734;867;405;4006
UK;3;UKJ14;Oxfordshire;3480;1018;610;5108
UK;2;UKJ2;Surrey, East and West Sussex;14783;2509;1370;18662
UK;3;UKJ21;Brighton and Hove;1404;390;202;1996
UK;3;UKJ22;East Sussex CC;2950;493;277;3720
UK;3;UKJ25;West Surrey;3988;631;345;4964
UK;3;UKJ26;East Surrey;2050;324;177;2551
UK;3;UKJ27;West Sussex (South West);2338;357;196;2891
UK;3;UKJ28;West Sussex (North East);2052;314;172;2538
UK;2;UKJ3;Hampshire and Isle of Wight;10113;1822;1019;12954
UK;3;UKJ31;Portsmouth;974;275;160;1409
UK;3;UKJ32;Southampton;1188;303;181;1672
UK;3;UKJ34;Isle of Wight;807;121;69;997
UK;3;UKJ35;South Hampshire;2368;372;202;2942
UK;3;UKJ36;Central Hampshire;2803;441;239;3483
UK;3;UKJ37;North Hampshire;1973;310;168;2451
UK;2;UKJ4;Kent;9002;1448;786;11236
UK;3;UKJ41;Medway;1300;225;122;1647
UK;3;UKJ43;Kent Thames Gateway;1770;282;153;2205
UK;3;UKJ44;East Kent;2659;421;229;3309
UK;3;UKJ45;Mid Kent;1435;228;124;1787
UK;3;UKJ46;West Kent;1837;292;158;2287
UK;1;UKK;SOUTH WEST (ENGLAND);29439;6298;3334;39071
UK;2;UKK1;Gloucestershire, Wiltshire and Bristol/Bath area;12870;3293;1714;17877
UK;3;UKK11;Bristol, City of;2176;773;404;3353
UK;3;UKK12;Bath and North East Somerset, North Somerset and South Gloucestershire;3484;859;462;4805
UK;3;UKK13;Gloucestershire;3446;714;405;4565
UK;3;UKK14;Swindon;1136;375;150;1661
UK;3;UKK15;Wiltshire CC;2627;573;293;3493
UK;2;UKK2;Dorset and Somerset;7225;1400;712;9337
UK;3;UKK21;Bournemouth and Poole;1826;491;211;2528
UK;3;UKK22;Dorset CC;2364;402;212;2978
UK;3;UKK23;Somerset;3035;507;289;3831
UK;2;UKK3;Cornwall and Isles of Scilly;3022;464;251;3737
UK;3;UKK30;Cornwall and Isles of Scilly;3022;464;251;3737
UK;2;UKK4;Devon;6322;1141;657;8120
UK;3;UKK41;Plymouth;1324;256;165;1745
UK;3;UKK42;Torbay;581;92;56;729
UK;3;UKK43;Devon CC;4417;793;436;5646
UK;1;UKL;WALES;19651;3001;1839;24491
UK;2;UKL1;West Wales and The Valleys;12587;1645;1063;15295
UK;3;UKL11;Isle of Anglesey;471;55;30;556
UK;3;UKL12;Gwynedd;848;123;76;1047
UK;3;UKL13;Conwy and Denbighshire;1537;217;134;1888
UK;3;UKL14;South West Wales;2501;301;198;3000
UK;3;UKL15;Central Valleys;1857;234;161;2252
UK;3;UKL16;Gwent Valleys;2162;245;158;2565
UK;3;UKL17;Bridgend and Neath Port Talbot;1774;229;147;2150
UK;3;UKL18;Swansea;1436;241;160;1837
UK;2;UKL2;East Wales;7064;1356;776;9196
UK;3;UKL21;Monmouthshire and Newport;1514;315;159;1988
UK;3;UKL22;Cardiff and Vale of Glamorgan;2655;650;392;3697
UK;3;UKL23;Flintshire and Wrexham;1960;269;152;2381
UK;3;UKL24;Powys;934;121;73;1128
UK;1;UKM;SCOTLAND;35554;7183;4218;46955
UK;2;UKM2;Eastern Scotland;13572;2964;1659;18195
UK;3;UKM21;Angus and Dundee City;1930;303;215;2448
UK;3;UKM22;Clackmannanshire and Fife;2692;314;230;3236
UK;3;UKM23;East Lothian and Midlothian;1172;147;100;1419
UK;3;UKM24;Scottish Borders;841;114;63;1018
UK;3;UKM25;Edinburgh, City of;3122;1366;676;5164
UK;3;UKM26;Falkirk;988;131;87;1206
UK;3;UKM27;Perth & Kinross and Stirling;1744;339;171;2254
UK;3;UKM28;West Lothian;1082;251;116;1449
UK;2;UKM3;South Western Scotland;15162;2895;1708;19765
UK;3;UKM31;East Dunbartonshire, West Dunbartonshire and Helensburgh & Lomond;1439;192;139;1770
UK;3;UKM32;Dumfries & Galloway;1110;148;87;1345
UK;3;UKM33;East Ayrshire and North Ayrshire mainland;1663;173;133;1969
UK;3;UKM34;Glasgow City;3811;1292;696;5799
UK;3;UKM35;Inverclyde, East Renfrewshire and Renfrewshire;2226;356;212;2794
UK;3;UKM36;North Lanarkshire;2075;305;186;2566
UK;3;UKM37;South Ayrshire;764;138;74;976
UK;3;UKM38;South Lanarkshire;2073;291;182;2546
UK;2;UKM5;North Eastern Scotland;3341;806;541;4688
UK;3;UKM50;Aberdeen City and Aberdeenshire;3341;806;541;4688
UK;2;UKM6;Highlands and Islands;3478;517;309;4304
UK;3;UKM61;Caithness & Sutherland and Ross & Cromarty;736;85;49;870
UK;3;UKM62;Inverness & Nairn and Moray, Badenoch & Strathspey;1453;241;149;1843
UK;3;UKM63;Lochaber, Skye & Lochalsh, Arran & Cumbrae and Argyll & Bute;789;121;66;976
UK;3;UKM64;Eilean Siar (Western Isles);186;25;15;226
UK;3;UKM65;Orkney Islands;147;19;12;178
UK;3;UKM66;Shetland Islands;168;27;18;213
UK;1;UKN;NORTHERN IRELAND;9523;1738;1106;12367
UK;2;UKN0;Northern Ireland;9523;1738;1106;12367
UK;3;UKN01;Belfast;1474;561;356;2391
UK;3;UKN02;Outer Belfast;2072;307;195;2574
UK;3;UKN03;East of Northern Ireland;2298;337;212;2847
UK;3;UKN04;North of Northern Ireland;1569;226;153;1948
UK;3;UKN05;West and South of Northern Ireland;2110;306;191;2607
UK;1;UKZ;EXTRA-REGIO NUTS 1;;;;0
UK;2;UKZZ;Extra-Regio NUTS 2;;;;0
UK;3;UKZZZ;Extra-Regio NUTS 3;;;;0
IS;0;IS;ICELAND;5158;1420;736;7314
IS;1;IS0;ICELAND;5158;1420;736;7314
IS;2;IS00;Iceland;5158;1420;736;7314
IS;3;IS001;Höfuðborgarsvæði;2846;821;425;4092
IS;3;IS002;Landsbyggð;2312;599;310;3221
IS;1;ISZ;EXTRA-REGIO NUTS 1;;;;0
IS;2;ISZZ;Extra-Regio NUTS 2;;;;0
IS;3;ISZZZ;Extra-Regio NUTS 3;;;;0
LI;0;LI;LIECHTENSTEIN;;;;0
LI;1;LI0;LIECHTENSTEIN;;;;0
LI;2;LI00;Liechtenstein;;;;0
LI;3;LI000;Liechtenstein;;;;0
LI;1;LIZ;EXTRA-REGIO NUTS 1;;;;0
LI;2;LIZZ;Extra-Regio NUTS 2;;;;0
LI;3;LIZZZ;Extra-Regio NUTS 3;;;;0
NO;0;NO0;NORGE;32339;8882;5697;46918
NO;1;NO1;NORGE;;;;0
NO;2;NO01;Oslo og Akershus;6241;2017;1273;9531
NO;3;NO011;Oslo;3045;1087;680;4812
NO;3;NO012;Akershus;3196;930;594;4720
NO;2;NO02;Hedmark og Oppland;3069;735;474;4278
NO;3;NO021;Hedmark;1518;368;237;2123
NO;3;NO022;Oppland;1551;367;237;2155
NO;2;NO03;Sør-Østlandet;6510;1733;1100;9343
NO;3;NO031;Østfold;1854;500;315;2669
NO;3;NO032;Buskerud;1866;506;323;2695
NO;3;NO033;Vestfold;1537;410;260;2207
NO;3;NO034;Telemark;1253;317;202;1772
NO;2;NO04;Agder og Rogaland;4526;1188;773;6487
NO;3;NO041;Aust-Agder;754;188;121;1063
NO;3;NO042;Vest-Agder;1060;281;182;1523
NO;3;NO043;Rogaland;2712;719;471;3902
NO;2;NO05;Vestlandet;5597;1501;974;8072
NO;3;NO051;Hordaland;3075;861;555;4491
NO;3;NO052;Sogn og Fjordane;770;192;126;1088
NO;3;NO053;Møre og Romsdal;1752;448;293;2493
NO;2;NO06;Trøndelag;2836;774;500;4110
NO;3;NO061;Sør-Trøndelag;1887;534;344;2765
NO;3;NO062;Nord-Trøndelag;949;240;156;1345
NO;2;NO07;Nord-Norge;3559;933;602;5094
NO;3;NO071;Nordland;1779;458;296;2533
NO;3;NO072;Troms;1158;308;199;1665
NO;3;NO073;Finnmark;622;166;107;895
NO;1;NOZ;EXTRA-REGIO NUTS 1;9;5;3;17
NO;2;NOZZ;Extra-Regio NUTS 2;9;5;3;17
NO;3;NOZZZ;Extra-Regio NUTS 3;9;5;3;17
CH;0;CH;SCHWEIZ / SUISSE / SVIZZERA;56849;13112;7918;77879
CH;1;CH0;SCHWEIZ / SUISSE / SVIZZERA;56849;13112;7918;77879
CH;2;CH01;Région lémanique;10971;2529;1522;15022
CH;3;CH011;Vaud;4918;1153;701;6772
CH;3;CH012;Valais;3308;653;398;4359
CH;3;CH013;Geneva;2744;723;423;3890
CH;2;CH02;Espace Mittelland;12881;2938;1787;17606
CH;3;CH021;Berne;7447;1646;1005;10098
CH;3;CH022;Fribourg;1776;451;266;2493
CH;3;CH023;Solothurn;1824;422;257;2503
CH;3;CH024;Neuchâtel;1327;301;187;1815
CH;3;CH025;Jura;508;118;72;698
CH;2;CH03;Nordwestschweiz;7314;1740;1040;10094
CH;3;CH031;Basel-Stadt;1434;315;186;1935
CH;3;CH032;Basel-Landschaft;1926;448;273;2647
CH;3;CH033;Aargau;3954;976;580;5510
CH;2;CH04;Zürich;9459;2269;1347;13075
CH;3;CH040;Zürich;9459;2269;1347;13075
CH;2;CH05;Ostschweiz;8267;1837;1121;11225
CH;3;CH051;Glarus;353;72;47;472
CH;3;CH052;Schaffhausen;500;120;70;690
CH;3;CH053;Appenzell Ausserrhoden;388;88;55;531
CH;3;CH054;Appenzell Innerrhoden;107;25;16;148
CH;3;CH055;St. Gallen;3291;765;476;4532
CH;3;CH056;Grisons;2134;389;237;2760
CH;3;CH057;Thurgau;1495;378;221;2094
CH;2;CH06;Zentralschweiz;5078;1205;749;7032
CH;3;CH061;Lucerne;2493;606;372;3471
CH;3;CH062;Uri;266;59;38;363
CH;3;CH063;Schwyz;978;230;143;1351
CH;3;CH064;Obwalden;291;62;40;393
CH;3;CH065;Nidwalden;313;70;45;428
CH;3;CH066;Zug;736;178;111;1025
CH;2;CH07;Ticino;2879;593;352;3824
CH;3;CH070;Ticino;2879;593;352;3824
CH;1;CHZ;EXTRA-REGIO NUTS 1;;;;0
CH;2;CHZZ;Extra-Regio NUTS 2;;;;0
CH;3;CHZZZ;Extra-Regio NUTS 3;;;;0
ME;0;ME;MONTENEGRO;;;;0
ME;1;ME0;MONTENEGRO;;;;0
ME;2;ME00;Montenegro;;;;0
ME;3;ME000;Montenegro;;;;0
ME;1;MEZ;EXTRA-REGIO NUTS 1;;;;0
ME;2;MEZZ;Extra-Regio NUTS 2;;;;0
ME;3;MEZZZ;Extra-Regio NUTS 3;;;;0
MK;0;MK;PORANEŠNATA JUGOSLOVENSKA REPUBLIKA MAKEDONIJA;;;;0
MK;1;MK0;PORANEŠNATA JUGOSLOVENSKA REPUBLIKA MAKEDONIJA;;;;0
MK;2;MK00;Poranešnata jugoslovenska Republika Makedonija;;;;0
MK;3;MK001;Vardarski;;;;0
MK;3;MK002;Istocen;;;;0
MK;3;MK003;Jugozapaden;;;;0
MK;3;MK004;Jugoistocen;;;;0
MK;3;MK005;Pelagoniski;;;;0
MK;3;MK006;Pološki;;;;0
MK;3;MK007;Severoistocen;;;;0
MK;3;MK008;Skopski;;;;0
MK;1;MKZ;EXTRA-REGIO NUTS 1;;;;0
MK;2;MKZZ;Extra-Regio NUTS 2;;;;0
MK;3;MKZZZ;Extra-Regio NUTS 3;;;;0
AL;0;AL;REPUBLIKA E SHQIPËRISË;;;;0
AL;1;AL0;REPUBLIKA E SHQIPËRISË;;;;0
AL;2;AL01;Northern Albania;;;;0
AL;3;AL011;Dibër;;;;0
AL;3;AL012;Durrës;;;;0
AL;3;AL013;Kukës;;;;0
AL;3;AL014;Lezhë;;;;0
AL;3;AL015;Shkodër;;;;0
AL;2;AL02;Central Albania;;;;0
AL;3;AL021;Elbasan;;;;0
AL;3;AL022;Tirana;;;;0
AL;2;AL03;Southern Albania;;;;0
AL;3;AL031;Berat;;;;0
AL;3;AL032;Fier;;;;0
AL;3;AL033;Gjirokastër;;;;0
AL;3;AL034;Korçë;;;;0
AL;3;AL035;Vlorë;;;;0
AL;1;ALZ;EXTRA-REGIO NUTS 1;;;;0
AL;2;ALZZ;Extra-Regio NUTS 2;;;;0
AL;3;ALZZZ;Extra-Regio NUTS 3;;;;0
BA;0;BA;BOSNA I HERCEGOVINA;;;;0
BA;1;BA0;BOSNA I HERCEGOVINA;;;;0
BA;2;BA01;Federacija Bosne i Hercegovine;;;;0
BA;3;BA011;Unsko-sanski;;;;0
BA;3;BA012;Posavski;;;;0
BA;3;BA013;Tuzlanski;;;;0
BA;3;BA014;Zeni?ko-dobojski;;;;0
BA;3;BA015;Bosansko-podrinjski;;;;0
BA;3;BA016;Bosansko-podrinjski;;;;0
BA;3;BA017;Hercegova?ko-neretvanski;;;;0
BA;3;BA018;Zapadnohercegova?ki;;;;0
BA;3;BA019;Sarajevo;;;;0
BA;3;BA01A;Livanjski;;;;0
BA;2;BA02;Republika Srpska;;;;0
BA;3;BA021;Republika Srpska;;;;0
BA;2;BA03;Distrikt Br?ko;;;;0
BA;3;BA031;Distrikt Br?ko;;;;0
BA;1;BAZ;EXTRA-REGIO NUTS 1;;;;0
BA;2;BAZZ;Extra-Regio NUTS 2;;;;0
BA;3;BAZZZ;Extra-Regio NUTS 3;;;;0
KO;0;KO;REPUBKOKA KOSOVO;;;;0
KO;1;KO0;REPUBKOKA KOSOVO;;;;0
KO;2;KO00;RepubKOka Kosovo;;;;0
KO;3;KO000;RepubKOka Kosovo;;;;0
KO;1;KOZ;EXTRA-REGIO NUTS 1;;;;0
KO;2;KOZZ;Extra-Regio NUTS 2;;;;0
KO;3;KOZZZ;Extra-Regio NUTS 3;;;;0
RS;0;RS;REPUBLIKA SRBIJA;;;;0
RS;1;RS0;REPUBLIKA SRBIJA;;;;0
RS;2;RS01;Serbia-North;;;;0
RS;3;RS011;Vojvodina;;;;0
RS;3;RS012;Belgrade;;;;0
RS;2;RS02;Serbia-South;;;;0
RS;3;RS021;Šumadija and Western Serbia;;;;0
RS;3;RS022;Southern and Eastern Serbia;;;;0
RS;3;RS023;Kosovo and Metohija;;;;0
RS;1;RSZ;EXTRA-REGIO NUTS 1;;;;0
RS;2;RSZZ;Extra-Regio NUTS 2;;;;0
RS;3;RSZZZ;Extra-Regio NUTS 3;;;;0
